player,games_as_white,games_as_black,games_as_white_and_black,nationality,birthyear
"Korchnoi, Viktor",1923,1853,3776,Switzerland,1931
"Timman, Jan H.",1486,1436,2922,Netherlands,1951
"Beliavsky, Alexander G.",1450,1384,2834,Slovenia,1953
"Shirov, Alexei",1438,1356,2794,Latvia,1972
"Ivanchuk, Vasyl",1355,1354,2709,Ukraine,1969
"Adams, Michael",1320,1270,2590,England,1971
"Portisch, Lajos",1284,1236,2520,Hungary,1937
"Gligoric, Svetozar",1284,1228,2512,Serbia,1923
"Van Wely, Loek",1244,1221,2465,Netherlands,1972
"Romanishin, Oleg M.",1140,1180,2320,Ukraine,1952
"Short, Nigel D.",1162,1097,2259,England,1965
"Sokolov, Ivan",1151,1103,2254,Bosnia and Herzegovina,1968
"Ftacnik, Lubomir",1135,1089,2224,Slovakia,1957
"Gelfand, Boris",1113,1058,2171,Israel,1968
"Kozul, Zdenko",1089,1081,2170,Croatia,1966
"Hort, Vlastimil",1119,1048,2167,Germany,1944
"Uhlmann, Wolfgang",1120,1038,2158,Germany,1935
"Anand, Viswanathan",1092,1040,2132,India,1969
"Smyslov, Vasily",1085,1045,2130,Russia,1921
"Svidler, Peter",1092,1020,2112,Russia,1976
"Larsen, Bent",1049,1062,2111,Denmark,1935
"Georgiev, Kiril",1095,1013,2108,Bulgaria,1965
"Dreev, Aleksey",1058,1002,2060,Russia,1969
"Karpov, Anatoly",1120,939,2059,Russia,1951
"Jansa, Vlastimil",1032,995,2027,Czech Republic,1942
"Navara, David",1001,1020,2021,Czech Republic,1985
"Tiviakov, Sergei",1031,927,1958,Netherlands,1973
"Andersson, Ulf",945,965,1910,Sweden,1951
"Aronian, Levon",964,936,1900,Armenia,1982
"Krasenkow, Michal",931,951,1882,Poland,1963
"Bacrot, Etienne",963,913,1876,France,1983
"Ivkov, Borislav",920,944,1864,Serbia,1933
"Tal, Mikhail N.",971,890,1861,Latvia,1936
"Damljanovic, Branko",946,902,1848,Serbia,1961
"Vachier-Lagrave, Maxime",942,896,1838,France,1990
"Miles, Anthony J.",945,888,1833,England,1955
"Vaganian, Rafael A.",920,898,1818,Armenia,1951
"Naiditsch, Arkadij",966,849,1815,Germany,1985
"Geller, Efim P.",979,836,1815,Russia,1925
"Bologan, Victor",935,868,1803,Moldova,1971
"Mamedyarov, Shakriyar",923,868,1791,Azerbaijan,1985
"Rozentalis, Eduardas",933,849,1782,Lithuania,1963
"Nikolic, Predrag",903,873,1776,Bosnia and Herzegovina,1960
"Caruana, Fabiano",890,863,1753,USA,1992
"Smirin, Ilia",863,879,1742,Israel,1968
"Korneev, Oleg",900,829,1729,Russia,1969
"Movsesian, Sergei",911,818,1729,Armenia,1978
"Socko, Bartosz",873,849,1722,Poland,1978
"Taimanov, Mark E.",861,843,1704,Russia,1926
"Spassky, Boris V.",872,831,1703,Russia,1937
"Grischuk, Alexander",886,817,1703,Russia,1983
"Gurevich, Mikhail",897,797,1694,Belgium,1959
"Huebner, Robert",854,836,1690,Germany,1948
"Farago, Ivan",848,835,1683,Hungary,1946
"Jussupow, Artur",821,846,1667,Germany,1960
"Kramnik, Vladimir",849,814,1663,Russia,1975
"Epishin, Vladimir",876,781,1657,Russia,1965
"Carlsen, Magnus",827,808,1635,Norway,1990
"Cheparinov, Ivan",818,815,1633,Bulgaria,1986
"Tukmakov, Vladimir B.",825,797,1622,Ukraine,1946
"Harikrishna, Pentala",834,783,1617,India,1986
"Hector, Jonny",823,792,1615,Sweden,1964
"Fressinet, Laurent",819,789,1608,France,1981
"Szabo, Laszlo",811,795,1606,Hungary,1917
"Hracek, Zbynek",802,782,1584,Czech Republic,1970
"Polugaevsky, Lev A.",822,759,1581,Russia,1934
"Bronstein, David I.",800,781,1581,Russia,1924
"Postny, Evgeny",789,788,1577,Israel,1981
"Nisipeanu, Liviu-Dieter",799,776,1575,Romania,1976
"Nakamura, Hikaru",797,769,1566,USA,1987
"Wojtaszek, Radoslaw",820,732,1552,Poland,1987
"Sax, Gyula",817,734,1551,Hungary,1951
"Aleksandrov, Aleksej",782,765,1547,Belarus,1973
"Topalov, Veselin",767,769,1536,Bulgaria,1975
"Ehlvest, Jaan",787,742,1529,Estonia,1962
"Petrosian, Tigran V.",807,721,1528,Armenia,1929
"Vallejo Pons, Francisco",777,751,1528,Spain,1982
"Kholmov, Ratmir D.",768,759,1527,Russia,1925
"Kamsky, Gata",765,756,1521,USA,1974
"Balashov, Yuri S.",768,748,1516,Russia,1949
"Karjakin, Sergey",784,729,1513,Russia,1990
"Giri, Anish",770,741,1511,Netherlands,1994
"Kotronias, Vasilios",776,729,1505,Greece,1964
"Bartel, Mateusz",759,742,1501,Poland,1985
"Sasikiran, Krishnan",768,731,1499,India,1981
"Ljubojevic, Ljubomir",777,709,1486,Serbia,1950
"Leko, Peter",756,728,1484,Hungary,1979
"Eljanov, Pavel",748,729,1477,Ukraine,1983
"Keres, Paul",757,710,1467,Estonia,1916
"Akopian, Vladimir E.",761,704,1465,Armenia,1971
"Korobov, Anton",746,717,1463,Ukraine,1985
"Kurajica, Bojan",718,740,1458,Bosnia and Herzegovina,1947
"Cebalo, Miso",752,705,1457,Croatia,1945
"Ponomariov, Ruslan",738,706,1444,Ukraine,1983
"Nijboer, Friso",745,698,1443,Netherlands,1965
"Sveshnikov, Evgeny",729,711,1440,Russia,1950
"Ribli, Zoltan",782,654,1436,Hungary,1951
"Cramling, Pia",710,724,1434,Sweden,1963
"Fridman, Daniel",748,683,1431,Germany,1976
"Volkov, Sergey",757,674,1431,Russia,1974
"Tseshkovsky, Vitaly",746,685,1431,Russia,1944
"Bauer, Christian",723,706,1429,France,1977
"Ivanisevic, Ivan",735,689,1424,Serbia,1977
"Speelman, Jon S.",689,733,1422,England,1956
"Najer, Evgeniy",738,683,1421,Russia,1977
"Zvjaginsev, Vadim",730,686,1416,Russia,1976
"Khalifman, Alexander",722,694,1416,Russia,1966
"Najdorf, Miguel",710,699,1409,Argentina,1910
"Nepomniachtchi, Ian",715,681,1396,Russia,1990
"Tregubov, Pavel V.",705,683,1388,Russia,1971
"Sutovsky, Emil",706,679,1385,Israel,1977
"Csom, Istvan",673,711,1384,Hungary,1940
"Almasi, Zoltan",701,678,1379,Hungary,1976
"Gulko, Boris F.",685,689,1374,USA,1947
"Motylev, Alexander",709,660,1369,Russia,1979
"Burmakin, Vladimir",688,675,1363,Russia,1967
"Inarkiev, Ernesto",700,653,1353,Russia,1985
"Saric, Ivan",686,666,1352,Croatia,1990
"Stefansson, Hannes",709,640,1349,Iceland,1972
"Donner, Jan-Hein",674,674,1348,Netherlands,1927
"Jobava, Baadur",695,650,1345,Georgia,1983
"Matulovic, Milan",720,624,1344,Serbia,1935
"Jakovenko, Dmitry",671,672,1343,Russia,1983
"Van der Wiel, John TH",658,680,1338,Netherlands,1959
"Smejkal, Jan",691,634,1325,Czech Republic,1946
"Nevednichy, Vladislav",694,629,1323,Romania,1969
"Panno, Oscar",642,679,1321,Argentina,1935
"Kupreichik, Viktor D.",688,630,1318,Belarus,1949
"Shabalov, Alexander",643,661,1304,USA,1967
"L'Ami, Erwin",654,644,1298,Netherlands,1985
"Gheorghiu, Florin",648,646,1294,Romania,1944
"Yu, Yangyi",659,631,1290,China,1994
"Bareev, Evgeny",675,615,1290,Russia,1966
"Zelcic, Robert",683,603,1286,Croatia,1965
"Sargissian, Gabriel",660,625,1285,Armenia,1983
"Kasparov, Garry",634,646,1280,Russia,1963
"Malaniuk, Vladimir P.",629,646,1275,Ukraine,1957
"Volokitin, Andrei",646,629,1275,Ukraine,1986
"Westerinen, Heikki MJ",626,649,1275,Finland,1944
"Granda Zuniga, Julio E.",643,629,1272,Peru,1967
"Ganguly, Surya Shekhar",694,576,1270,India,1983
"Malakhov, Vladimir",649,619,1268,Russia,1980
"Macieja, Bartlomiej",651,616,1267,Poland,1977
"Vitiugov, Nikita",668,598,1266,Russia,1987
"Bu, Xiangzhi",637,624,1261,China,1985
"Atalik, Suat",610,641,1251,Turkey,1964
"Velimirovic, Dragoljub",632,618,1250,Serbia,1942
"Pelletier, Yannick",644,605,1249,Switzerland,1976
"Hebden, Mark L.",610,637,1247,England,1958
"Radjabov, Teimour",607,637,1244,Azerbaijan,1987
"Christiansen, Larry M.",635,607,1242,USA,1956
"Sokolov, Andrei",587,652,1239,France,1963
"Moiseenko, Alexander",648,590,1238,Ukraine,1980
"Grandelius, Nils",618,618,1236,Sweden,1993
"Matanovic, Aleksandar",638,593,1231,Serbia,1930
"Alekseev, Evgeny",641,589,1230,Russia,1985
"Vasiukov, Evgeni A.",634,595,1229,Russia,1933
"Godena, Michele",590,638,1228,Italy,1967
"Fedorchuk, Sergey A.",621,607,1228,Ukraine,1981
"Fier, Alexandr",625,601,1226,Brazil,1988
"Browne, Walter S.",619,604,1223,USA,1949
"Morozevich, Alexander",602,619,1221,Russia,1977
"Psakhis, Lev B.",601,619,1220,Israel,1958
"Timofeev, Artyom",614,606,1220,Russia,1985
"Dominguez Perez, Leinier",622,598,1220,Cuba,1983
"Bruzon Batista, Lazaro",636,582,1218,Cuba,1982
"Palac, Mladen",657,559,1216,Croatia,1971
"Spraggett, Kevin",621,595,1216,Canada,1954
"Stocek, Jiri",587,623,1210,Czech Republic,1977
"Tartakower, Savielly",604,603,1207,Poland,1887
"Stefanova, Antoaneta",600,601,1201,Bulgaria,1979
"Lputian, Smbat G.",615,585,1200,Armenia,1958
"Delchev, Aleksander",631,566,1197,Bulgaria,1971
"Kempinski, Robert",607,587,1194,Poland,1977
"Hillarp Persson, Tiger",601,591,1192,Sweden,1970
"So, Wesley",608,579,1187,USA,1993
"Iordachescu, Viorel",612,573,1185,Moldova,1977
"Torre, Eugenio",592,593,1185,Philippines,1951
"Schmidt, Wlodzimierz",576,605,1181,Poland,1943
"Wang, Hao",603,576,1179,China,1989
"Pachman, Ludek",600,576,1176,Czech Republic,1924
"Lautier, Joel",625,549,1174,France,1973
"Onischuk, Alexander",585,586,1171,USA,1975
"Rossetto, Hector",593,575,1168,Argentina,1922
"Babula, Vlastimil",600,564,1164,Czech Republic,1973
"Van der Sterren, Paul",573,583,1156,Netherlands,1956
"Kuzubov, Yuriy",591,564,1155,Ukraine,1990
"Ree, Hans",587,568,1155,Netherlands,1944
"Unzicker, Wolfgang",569,578,1147,Germany,1925
"Kulaots, Kaido",587,559,1146,Estonia,1976
"Jones, Gawain CB",593,551,1144,England,1987
"Lobron, Eric",592,550,1142,Germany,1960
"Polgar, Judit",570,569,1139,Hungary,1976
"Fedorov, Alexei",562,577,1139,Belarus,1972
"Barcza, Gedeon",567,571,1138,Hungary,1911
"Sedlak, Nikola",557,579,1136,Serbia,1983
"Bischoff, Klaus",563,570,1133,Germany,1961
"Ragger, Markus",563,567,1130,Austria,1988
"Efimenko, Zahar",581,548,1129,Ukraine,1985
"Edouard, Romain",585,541,1126,France,1990
"Dvoirys, Semen I.",586,540,1126,Russia,1958
"Mikhalevski, Victor",566,560,1126,Israel,1972
"Khenkin, Igor",607,518,1125,Germany,1968
"Matlakov, Maxim",567,557,1124,Russia,1991
"Nunn, John DM",580,544,1124,England,1955
"Suba, Mihai",590,533,1123,Romania,1947
"Brkic, Ante",561,555,1116,Croatia,1988
"Boensch, Uwe",566,547,1113,Germany,1958
"Vogt, Lothar",565,547,1112,Germany,1952
"Bellon Lopez, Juan Manuel",564,545,1109,Spain,1950
"Piket, Jeroen",546,562,1108,Netherlands,1969
"Euwe, Max",570,537,1107,Netherlands,1901
"Glek, Igor",558,548,1106,Russia,1961
"Mamedov, Rauf",548,557,1105,Azerbaijan,1988
"Romanov, Evgeny",557,547,1104,Russia,1988
"Kobalia, Mikhail",564,539,1103,Russia,1978
"Sethuraman, SP",559,544,1103,India,1993
"McShane, Luke J.",560,542,1102,England,1984
"Kuzmin, Gennadi P.",583,516,1099,Russia,1946
"Sjugirov, Sanan",557,539,1096,Russia,1993
"Rublevsky, Sergei",593,503,1096,Russia,1974
"Kasimdzhanov, Rustam",534,559,1093,Uzbekistan,1979
"Berkes, Ferenc",565,524,1089,Hungary,1985
"Benko, Pal C.",558,531,1089,Hungary,1928
"Rogers, Ian",567,521,1088,Australia,1960
"Svetushkin, Dmitry",564,523,1087,Moldova,1980
"De Firmian, Nick E.",550,535,1085,USA,1957
"Kindermann, Stefan",566,519,1085,Germany,1959
"Miezis, Normunds",514,571,1085,Latvia,1971
"Parligras, Mircea-Emilian",555,528,1083,Romania,1980
"Seirawan, Yasser",556,527,1083,USA,1960
"Narciso Dublan, Marc",531,552,1083,Spain,1973
"Illescas Cordoba, Miguel",537,544,1081,Spain,1965
"Chandler, Murray G.",547,532,1079,New Zealand,1960
"Cvitan, Ognjen",533,545,1078,Croatia,1961
"David, Alberto",544,534,1078,Luxembourg,1970
"Reshevsky, Samuel",543,533,1076,USA,1911
"Kosteniuk, Alexandra",540,532,1072,Russia,1984
"Varga, Zoltan",522,548,1070,Hungary,1974
"Tomashevsky, Evgeny",558,511,1069,Russia,1987
"Bocharov, Dmitry",522,544,1066,Russia,1982
"Gupta, Abhijeet",544,520,1064,India,1989
"Plachetka, Jan",536,525,1061,Slovakia,1952
"Mchedlishvili, Mikheil",520,539,1059,Georgia,1979
"Howell, David WL",514,544,1058,England,1990
"Donchenko, Alexander",530,519,1049,Germany,1998
"Neverov, Valeriy",521,527,1048,Ukraine,1964
"Istratescu, Andrei",522,525,1047,Romania,1975
"Ding, Liren",531,514,1045,China,1992
"Rapport, Richard",531,510,1041,Hungary,1996
"Nielsen, Peter Heine",523,518,1041,Denmark,1973
"Forintos, Gyozo V.",512,527,1039,Hungary,1935
"Hjartarson, Johann",498,540,1038,Iceland,1963
"Khismatullin, Denis",520,515,1035,Russia,1984
"Bogoljubow, Efim",523,504,1027,Germany,1889
"Landa, Konstantin",524,501,1025,Russia,1972
"Fedoseev, Vladimir",522,502,1024,Russia,1995
"Conquest, Stuart C.",528,493,1021,England,1967
"Kavalek, Lubomir",520,499,1019,USA,1943
"Ruck, Robert",491,528,1019,Hungary,1977
"Areshchenko, Alexander",534,483,1017,Ukraine,1986
"Ilincic, Zlatko",499,517,1016,Serbia,1977
"Balogh, Csaba",513,502,1015,Hungary,1987
"Rodshtein, Maxim",514,498,1012,Israel,1989
"Laznicka, Viktor",499,512,1011,Czech Republic,1988
"Campora Sivori, Daniel Hugo",484,526,1010,Argentina,1957
"Zapata, Alonso",501,509,1010,Colombia,1958
"Adhiban, Baskaran",499,509,1008,India,1992
"Van Foreest, Jorden",518,490,1008,Netherlands,1999
"Safarli, Eltaj",513,493,1006,Azerbaijan,1992
"Markus, Robert",537,466,1003,Serbia,1983
"Chanda, Sandipan",501,501,1002,India,1983
"Savchenko, Boris",498,501,999,Russia,1986
"Benjamin, Joel",502,495,997,USA,1964
"Luther, Thomas",521,474,995,Germany,1969
"Spielmann, Rudolf",487,507,994,Austria,1883
"Petursson, Margeir",507,485,992,Iceland,1960
"Hou, Yifan",495,497,992,China,1994
"Wang, Yue",508,483,991,China,1987
"Marshall, Frank",495,495,990,USA,1877
"Grachev, Boris",494,495,989,Russia,1986
"Savon, Vladimir A.",483,504,987,Ukraine,1940
"Marin, Mihail",491,494,985,Romania,1965
"Peralta, Fernando",503,481,984,Argentina,1979
"Lupulescu, Constantin",499,485,984,Romania,1984
"Gallagher, Joseph G.",475,508,983,Switzerland,1964
"Anton Guijarro, David",492,486,978,Spain,1995
"Ulybin, Mikhail",518,458,976,Russia,1971
"Kveinys, Aloyzas",501,474,975,Lithuania,1962
"Quinteros, Miguel Angel",470,505,975,Argentina,1947
"Piorun, Kacper",489,484,973,Poland,1991
"Suetin, Alexey S.",504,467,971,Russia,1926
"Graf, Alexander",489,481,970,Germany,1962
"Alekhine, Alexander",486,483,969,Russia,1892
"Baklan, Vladimir",516,453,969,Ukraine,1978
"Riazantsev, Alexander",499,468,967,Russia,1985
"Erdos, Viktor",506,461,967,Hungary,1987
"Bosiocic, Marin",488,476,964,Croatia,1987
"Rakhmanov, Aleksandr",489,473,962,Russia,1989
"Malakhatko, Vadim",483,475,958,Belgium,1977
"Zhigalko, Sergei",494,464,958,Belarus,1989
"Markowski, Tomasz",494,463,957,Poland,1975
"Sakaev, Konstantin",509,447,956,Russia,1974
"Ciocaltea, Victor",489,467,956,Romania,1932
"Milov, Vadim",492,459,951,Switzerland,1972
"Andreikin, Dmitry",486,462,948,Russia,1990
"Bilek, Istvan",466,482,948,Hungary,1932
"Stahlberg, Gideon",477,470,947,Sweden,1908
"Pinter, Jozsef",490,457,947,Hungary,1953
"Kovacevic, Aleksandar",482,461,943,Serbia,1974
"Ghaem Maghami, Ehsan",470,470,940,Iran,1982
"Zhou, Jianchao",454,485,939,China,1988
"Melkumyan, Hrant",479,458,937,Armenia,1989
"Lutz, Christopher",486,451,937,Germany,1971
"Stohl, Igor",463,474,937,Slovakia,1964
"Kryvoruchko, Yuriy",498,436,934,Ukraine,1986
"Vidit, Santosh Gujrathi",470,463,933,India,1994
"Blatny, Pavel",469,462,931,Czech Republic,1968
"Chernin, Alexander",490,440,930,Hungary,1959
"Horvath, Jozsef M.",465,465,930,Hungary,1964
"Ni, Hua",464,464,928,China,1983
"Hansen, Curt",464,464,928,Denmark,1964
"Vaisser, Anatoly",496,427,923,France,1949
"Lalic, Bogdan",460,462,922,Croatia,1964
"Indjic, Aleksandar",470,451,921,Serbia,1995
"Lerner, Konstantin Z.",479,441,920,Ukraine,1950
"Hodgson, Julian M.",463,454,917,England,1963
"Le, Quang Liem",466,451,917,Vietnam,1991
"Wells, Peter K.",446,469,915,England,1965
"Yudasin, Leonid",475,436,911,Israel,1959
"Swiercz, Dariusz",461,449,910,Poland,1994
"Ivanovic, Bozidar",450,458,908,Montenegro,1949
"Ponkratov, Pavel",458,450,908,Russia,1988
"Flear, Glenn C.",427,480,907,England,1959
"Berg, Emanuel",452,455,907,Sweden,1981
"Adorjan, Andras",428,478,906,Hungary,1950
"Gyimesi, Zoltan",467,438,905,Hungary,1977
"Espig, Lutz",449,453,902,Germany,1949
"Meier, Georg",452,449,901,Germany,1987
"Kosic, Dragan",420,480,900,Montenegro,1966
"Greenfeld, Alon",441,458,899,Israel,1964
"Dolmatov, Sergey",489,410,899,Russia,1959
"Gufeld, Eduard",438,461,899,Ukraine,1936
"Sulskis, Sarunas",458,438,896,Lithuania,1972
"Azmaiparashvili, Zurab",463,431,894,Georgia,1960
"Nogueiras Santiago, Jesus",454,436,890,Cuba,1959
"Ter-Sahakyan, Samvel",448,438,886,Armenia,1993
"Petrosian, Tigran L.",457,429,886,Armenia,1984
"Artemiev, Vladislav",459,426,885,Russia,1998
"Lukacs, Peter",482,403,885,Hungary,1950
"Iturrizaga Bonelli, Eduardo",448,434,882,Venezuela,1989
"Yilmaz, Mustafa",432,449,881,Turkey,1992
"Rodriguez Vila, Andres",444,437,881,Uruguay,1973
"Pilnik, Herman",437,441,878,Argentina,1914
"Pantsulaia, Levan",457,421,878,Georgia,1986
"Chatalbashev, Boris",443,433,876,Bulgaria,1974
"Jumabayev, Rinat",439,437,876,Kazakhstan,1989
"Damjanovic, Mato",431,444,875,Croatia,1927
"Popovic, Petar",452,422,874,Serbia,1959
"Bluebaum, Matthias",435,438,873,Germany,1997
"Stevic, Hrvoje",432,439,871,Croatia,1980
"Eliskases, Erich Gottlieb",435,436,871,Austria,1913
"Ibragimov, Ildar",439,431,870,Russia,1967
"Flohr, Salomon",437,432,869,Czech Republic,1908
"Solak, Dragan",434,431,865,Serbia,1980
"Yermolinsky, Alex",442,421,863,USA,1958
"Yakovich, Yuri",454,407,861,Russia,1962
"Degraeve, Jean-Marc",443,416,859,France,1971
"Wei, Yi",439,419,858,China,1999
"Pavlovic, Milos",414,444,858,Serbia,1964
"Goganov, Aleksey",424,433,857,Russia,1991
"Maghsoodloo, Parham",442,415,857,Iran,2000
"Duda, Jan-Krzysztof",430,427,857,Poland,1998
"Hulak, Krunoslav",407,443,850,Croatia,1951
"Azarov, Sergei",443,406,849,Belarus,1983
"Bagirov, Vladimir",406,442,848,Russia,1936
"Tkachiev, Vladislav",453,393,846,Kazakhstan,1973
"Miladinovic, Igor",433,410,843,Serbia,1974
"Eingorn, Vereslav S.",454,389,843,Ukraine,1956
"Abramovic, Bosko",404,439,843,Serbia,1951
"Li, Chao b",434,408,842,China,1989
"Ernst, Sipke",415,427,842,Netherlands,1979
"Langeweg, Kick",403,437,840,Netherlands,1937
"Kokarev, Dmitry",423,417,840,Russia,1988
"Janosevic, Dragoljub",444,394,838,Serbia,1923
"Akesson, Ralf",411,425,836,Sweden,1961
"Haba, Petr",427,408,835,Czech Republic,1986
"Rashkovsky, Nukhim N.",414,419,833,Russia,1946
"Dizdar, Goran",448,383,831,Croatia,1965
"Honfi, Karoly",418,410,828,Hungary,1930
"Kaidanov, Gregory S.",435,393,828,USA,1959
"Razuvaev, Yuri S.",460,368,828,Russia,1945
"Kovalenko, Igor",431,396,827,Latvia,1988
"Olafsson, Fridrik",405,422,827,Iceland,1935
"Botvinnik, Mikhail",423,404,827,Russia,1911
"Schlosser, Philipp",422,403,825,Germany,1968
"Averbakh, Yuri L.",415,408,823,Russia,1922
"Pavasovic, Dusko",414,407,821,Slovenia,1976
"Vajda, Levente",414,407,821,Romania,1981
"Strikovic, Aleksa",430,391,821,Serbia,1961
"Horvath, Csaba",419,401,820,Hungary,1972
"Vorobiov, Evgeny E.",402,417,819,Russia,1976
"Acs, Peter",401,417,818,Hungary,1981
"Tatai, Stefano",404,413,817,Italy,1945
"Sznapik, Aleksander",427,388,815,Poland,1951
"Dorfman, Iossif",423,392,815,France,1952
"Brunello, Sabino",392,423,815,Italy,1989
"Kovacevic, Vlatko",410,405,815,Croatia,1942
"Pirc, Vasja",403,410,813,Slovenia,1907
"Gajewski, Grzegorz",411,402,813,Poland,1985
"Filip, Miroslav",405,406,811,Czech Republic,1928
"Perunovic, Milos",412,398,810,Serbia,1984
"Shamkovich, Leonid",423,384,807,USA,1923
"Dronavalli, Harika",401,403,804,India,1991
"Andriasian, Zaven",388,413,801,Armenia,1989
"Potkin, Vladimir",408,392,800,Russia,1982
"Georgiev, Vladimir",399,401,800,Bulgaria,1975
"Koneru, Humpy",407,393,800,India,1987
"Dubov, Daniil",397,402,799,Russia,1996
"Kharlov, Andrei",409,389,798,Russia,1968
"Wade, Robert G.",389,407,796,New Zealand,1921
"Vera Gonzalez-Quevedo, Reynaldo",402,393,795,Cuba,1940
"Agdestein, Simen",393,402,795,Norway,1967
"Svane, Rasmus",383,412,795,Germany,1997
"Novikov, Igor A.",407,386,793,Ukraine,1961
"Muzychuk, Anna",415,378,793,Ukraine,1990
"Predojevic, Borki",384,408,792,Bosnia and Herzegovina,1987
"Halkias, Stelios",371,421,792,Greece,1980
"Brynell, Stellan",383,409,792,Sweden,1962
"Olafsson, Helgi",398,392,790,Iceland,1956
"Mirzoev, Azer",387,402,789,Azerbaijan,1978
"Mikhalchishin, Adrian",377,412,789,Ukraine,1954
"Miton, Kamil",390,396,786,Poland,1984
"Moskalenko, Viktor",393,392,785,Ukraine,1960
"Paehtz, Elisabeth",381,402,783,Germany,1985
"Trifunovic, Petar",407,376,783,Serbia,1910
"Groszpeter, Attila",384,399,783,Hungary,1938
"Agrest, Evgenij",417,366,783,Sweden,1966
"Gipslis, Aivars",401,382,783,Latvia,1937
"Amin, Bassem",399,383,782,Egypt,1988
"Klovans, Janis",409,371,780,Latvia,1935
"Chiburdanidze, Maia",387,392,779,Georgia,1961
"Dzagnidze, Nana",380,398,778,Georgia,1987
"Djuric, Stefan",377,401,778,Serbia,1955
"Bisguier, Arthur B.",397,380,777,USA,1929
"Gutman, Lev",371,406,777,Germany,1945
"Shankland, Samuel L.",398,379,777,USA,1991
"Guimard, Carlos Enrique",382,395,777,Argentina,1913
"Malich, Burkhard",393,383,776,Germany,1936
"Grigoryan, Karen H.",395,381,776,Armenia,1995
"Sarana, Alexey",399,373,772,Russia,2000
"Lein, Anatoly",397,375,772,USA,1931
"Marjanovic, Slavoljub",368,404,772,Serbia,1936
"Dautov, Rustem",389,382,771,Germany,1965
"Predke, Alexandr",399,372,771,Russia,1994
"Akobian, Varuzhan",401,369,770,USA,1983
"Bernadskiy, Vitaliy",407,363,770,Ukraine,1994
"O'Kelly de Galway, Alberic",386,384,770,Belgium,1911
"Esipenko, Andrey",384,385,769,Russia,2002
"Ju, Wenjun",372,396,768,China,1991
"Gurevich, Dmitry",378,390,768,USA,1956
"Van den Doel, Erik",389,379,768,Netherlands,1979
"Barczay, Laszlo",374,391,765,Hungary,1935
"Garcia Palermo, Carlos",384,379,763,Argentina,1953
"Drasko, Milan",376,386,762,Montenegro,1952
"Lopez Martinez, Josep Manuel",368,394,762,Spain,1980
"Lengyel, Levente",364,397,761,Hungary,1933
"Karlsson, Lars",392,368,760,Sweden,1955
"Chigaev, Maksim",379,381,760,Russia,1996
"Timoscenko, Gennadij",357,403,760,Ukraine,1957
"Janowski, Dawid Markelowicz",366,393,759,France,1868
"Buhmann, Rainer",393,366,759,Germany,1981
"Minasian, Artashes",391,366,757,Armenia,1967
"Avrukh, Boris",393,364,757,Israel,1978
"Mastrovasilis, Dimitrios",383,372,755,Greece,1983
"Morovic Fernandez, Ivan",370,385,755,Chile,1963
"Paoli, Enrico",387,367,754,Italy,1908
"Movsziszian, Karen",359,394,753,Armenia,1968
"Vukic, Milan",387,366,753,Bosnia and Herzegovina,1942
"Milos, Gilberto",384,369,753,Brazil,1963
"Gagunashvili, Merab",376,376,752,Georgia,1985
"Salem, AR Saleh",375,376,751,UAE,1993
"Heberla, Bartlomiej",362,389,751,Poland,1985
"Guseinov, Gadir",389,361,750,Azerbaijan,1986
"Maze, Sebastien",373,376,749,France,1984
"Stein, Leonid",378,370,748,Ukraine,1934
"Polak, Tomas",374,374,748,Czech Republic,1974
"Bok, Benjamin",392,356,748,Netherlands,1995
"Salgado Lopez, Ivan",385,361,746,Spain,1991
"Hamdouchi, Hicham",395,351,746,Morocco,1972
"Vocaturo, Daniele",383,361,744,Italy,1989
"Mortensen, Erling",384,360,744,Denmark,1946
"Lagno, Kateryna",383,361,744,Russia,1989
"Rubinstein, Akiba",369,374,743,Poland,1882
"Parma, Bruno",399,344,743,Slovenia,1941
"Meduna, Eduard",382,357,739,Czech Republic,1952
"Inkiov, Ventzislav",361,378,739,Bulgaria,1952
"Shimanov, Aleksandr",373,363,736,Russia,1992
"Tari, Aryan",384,352,736,Norway,1999
"Antipov, Mikhail Al",370,363,733,Russia,1997
"Banusz, Tamas",375,358,733,,
"Demchenko, Anton",376,355,731,,
"Tringov, Georgi P.",381,350,731,,
"Anastasian, Ashot",372,359,731,,
"Sanal, Vahap",346,385,731,,
"Ubilava, Elizbar",363,367,730,,
"Tischbierek, Raj",374,356,730,,
"Oparin, Grigoriy",367,363,730,,
"Pomar Salamanca, Arturo",358,369,727,,
"Mareco, Sandro",376,351,727,,
"Hovhannisyan, Robert",365,361,726,,
"Lu, Shanglei",379,346,725,,
"Kazhgaleyev, Murtas",377,346,723,,
"Byrne, Robert E.",361,360,721,,
"Wojtkiewicz, Aleksander",323,397,720,,
"Reinderman, Dimitri",363,356,719,,
"Sosonko, Gennadi P.",362,356,718,,
"Hertneck, Gerald",343,372,715,,
"Ermenkov, Evgenij",365,349,714,,
"Arencibia Rodriguez, Walter",358,351,709,,
"Magem Badals, Jordi",361,345,706,,
"Drazic, Sinisa",353,350,703,,
"Fedorowicz, John P.",328,375,703,,
"Lysyj, Igor",370,331,701,,
"Tabatabaei, M. Amin",351,349,700,,
"Kengis, Edvins",354,344,698,,
"Skembris, Spyridon",330,368,698,,
"Dizdarevic, Emir",335,363,698,,
"Hickl, Joerg",373,324,697,,
"Lagarde, Maxime",348,347,695,,
"Flores, Diego",339,355,694,,
"Rubinetti, Jorge",333,357,690,,
"Schandorff, Lars",343,347,690,,
"Maroczy, Geza",351,337,688,,
"Smirnov, Pavel",358,330,688,,
"Savchenko, Stanislav",375,312,687,,
"Kovalev, Vladislav",363,322,685,,
"Wedberg, Tom",346,339,685,,
"Solodovnichenko, Yuri",355,330,685,,
"Paravyan, David",354,330,684,,
"Popov, Ivan",349,335,684,,
"Yemelin, Vasily",342,342,684,,
"Del Rio De Angelis, Salvador G.",343,340,683,,
"Rausis, Igors",328,355,683,,
"Mieses, Jacques",345,338,683,,
"Nyback, Tomi",354,329,683,,
"Sliwa, Bogdan",338,344,682,,
"Padevsky, Nikola",330,352,682,,
"Robatsch, Karl",332,350,682,,
"Hammer, Jon Ludvig",360,321,681,,
"Alburt, Lev O.",329,352,681,,
"Hansen, Sune Berg",350,328,678,,
"Smeets, Jan",339,339,678,,
"Felgaer, Ruben",337,340,677,,
"Brodsky, Michail",367,310,677,,
"Medina-Garcia, Antonio",339,337,676,,
"Miroshnichenko, Evgenij",349,327,676,,
"Lanka, Zigurds",343,330,673,,
"Delgado Ramirez, Neuris",330,343,673,,
"Turov, Maxim",344,329,673,,
"Abasov, Nijat",336,336,672,,
"Pribyl, Josef",306,365,671,,
"Ivanov, Alexander USA",344,327,671,,
"Gleizerov, Evgeny",345,326,671,,
"Rodriguez Cespedes, Amador",355,314,669,,
"Ivanov, Sergey",326,343,669,,
"Renet, Olivier",335,333,668,,
"Blackburne, Joseph Henry",340,328,668,,
"Tarrasch, Siegbert",333,334,667,,
"Apicella, Manuel",325,342,667,,
"Robson, Ray",336,329,665,,
"Simacek, Pavel",325,340,665,,
"Cifuentes Parada, Roberto",331,333,664,,
"Chigorin, Mikhail",334,329,663,,
"Goryachkina, Aleksandra",330,333,663,,
"Praggnanandhaa, R.",332,330,662,,
"Banikas, Hristos",314,347,661,,
"Czebe, Attila",350,311,661,,
"Barlov, Dragan",327,333,660,,
"Radulov, Ivan",319,340,659,,
"Djukic, Nikola",332,326,658,,
"Rajkovic, Dusan",314,341,655,,
"Petrosyan, Manuel",325,329,654,,
"Shchekachev, Andrei",331,323,654,,
"Shulman, Yury",335,318,653,,
"Lenic, Luka",341,312,653,,
"Zaitsev, Igor A.",321,331,652,,
"Kovalev, Andrei",326,326,652,,
"Santos Latasa, Jaime",335,316,651,,
"Can, Emre",337,313,650,,
"Gunina, Valentina",327,323,650,,
"Kudrin, Sergey",321,328,649,,
"Zhang, Zhong",328,320,648,,
"Letelier Martner, Rene",325,323,648,,
"Lechtynsky, Jiri",304,343,647,,
"Chekhov, Valery A.",328,318,646,,
"Sevian, Samuel",326,320,646,,
"Horvath, Adam",321,324,645,,
"Huzman, Alexander",328,316,644,,
"Socko, Monika",315,329,644,,
"Durarbayli, Vasif",318,326,644,,
"Murey, Jacob",317,327,644,,
"Gavrikov, Viktor",335,308,643,,
"Rogozenco, Dorian",340,301,641,,
"Schlechter, Carl",324,316,640,,
"Zhigalko, Andrey",324,316,640,,
"Arnason, Jon L.",337,303,640,,
"Kogan, Arthur",320,318,638,,
"Czerniak, Moshe",306,332,638,,
"Grigoriants, Sergey",310,328,638,,
"Alekseenko, Kirill",330,307,637,,
"Ghitescu, Theodor",314,323,637,,
"Loginov, Valery A.",298,338,636,,
"Nabaty, Tamir",328,308,636,,
"Michalik, Peter",325,311,636,,
"Abdusattorov, Nodirbek",318,317,635,,
"Doda, Zbigniew",314,321,635,,
"Fischer, Robert J.",315,318,633,,
"Zhao, Xue",308,324,632,,
"Kunin, Vitaly",324,308,632,,
"Khairullin, Ildar",318,314,632,,
"Popov, Valerij",341,289,630,,
"Niemann, Hans Moke",317,313,630,,
"Zhao, Jun",309,321,630,,
"Kosten, Anthony C.",318,311,629,,
"Nguyen, Ngoc Truong Son",316,312,628,,
"Papp, Gabor",332,296,628,,
"Kluger, Gyula",319,308,627,,
"Arkell, Keith C.",318,308,626,,
"Saemisch, Friedrich",302,322,624,,
"Krush, Irina",316,308,624,,
"Wahls, Matthias",301,323,624,,
"Van Scheltinga, Theo D.",308,316,624,,
"Lenderman, Aleksandr",309,314,623,,
"Adamski, Jan",291,331,622,,
"Naumkin, Igor",275,347,622,,
"Negi, Parimarjan",323,299,622,,
"Keene, Raymond D.",310,312,622,,
"Pichot, Alan",311,311,622,,
"Gdanski, Jacek",306,315,621,,
"Kravtsiv, Martyn",326,294,620,,
"Tratar, Marko",244,376,620,,
"Knaak, Rainer",317,303,620,,
"Cordova, Emilio",310,307,617,,
"Timoshenko, Georgy",315,302,617,,
"Rustemov, Alexander",316,300,616,,
"Gustafsson, Jan",303,312,615,,
"Simagin, Vladimir",311,304,615,,
"Moussard, Jules",311,304,615,,
"Erigaisi, Arjun",306,308,614,,
"Hecht, Hans-Joachim",299,314,613,,
"Blomqvist, Erik",310,303,613,,
"Sigurjonsson, Gudmundur",313,300,613,,
"Kotov, Alexander A.",309,304,613,,
"Kristiansen, Jens",305,307,612,,
"Mista, Aleksander",316,295,611,,
"Oleksiyenko, Mykhaylo",306,304,610,,
"Dely, Peter",298,311,609,,
"Deac, Bogdan-Daniel",304,305,609,,
"Bednarski, Jacek B.",300,309,609,,
"Boleslavsky, Isaac",309,298,607,,
"Schmittdiel, Eckhard",282,325,607,,
"Oll, Lembit",321,284,605,,
"Kadric, Denis",302,303,605,,
"Bachmann, Axel",318,287,605,,
"Rahman, Ziaur",304,301,605,,
"Votava, Jan",299,304,603,,
"Ikonnikov, Vyacheslav",290,313,603,,
"Narayanan, Sunilduth Lyna",315,288,603,,
"Roiz, Michael",328,274,602,,
"Jaracz, Pawel",277,324,601,,
"Garcia Martinez, Silvino",290,310,600,,
"Jankovic, Alojzije",303,296,599,,
"Sunye Neto, Jaime",307,292,599,,
"Minic, Dragoljub",286,312,598,,
"Adly, Ahmed",295,303,598,,
"Leitao, Rafael",311,286,597,,
"Sengupta, Deep",308,288,596,,
"Martinovic, Sasa",291,305,596,,
"Nihal, Sarin",299,295,594,,
"Lalith, Babu MR",293,301,594,,
"Liberzon, Vladimir M.",304,289,593,,
"Amonatov, Farrukh",296,297,593,,
"Salov, Valery B.",296,297,593,,
"Franco Ocampos, Zenon",284,309,593,,
"Golod, Vitali",304,289,593,,
"Martirosyan, Haik M.",301,291,592,,
"Rotstein, Arkadij",312,280,592,,
"Firouzja, Alireza",305,286,591,,
"Sturua, Zurab",294,297,591,,
"Furman, Semyon Abramovich",309,282,591,,
"Mestel, A. Jonathan",285,306,591,,
"Sivuk, Vitaly",295,296,591,,
"Lau, Ralf",298,292,590,,
"Ornstein, Axel",287,303,590,,
"Ragozin, Viacheslav",305,285,590,,
"Kovchan, Alexander",289,300,589,,
"Gruenfeld, Yehuda",312,277,589,,
"Golombek, Harry",293,296,589,,
"Liebert, Heinz",286,302,588,,
"Martinovic, Slobodan",301,287,588,,
"Hansen, Lars Bo",296,291,587,,
"Werle, Jan",303,284,587,,
"Kurnosov, Igor",312,275,587,,
"Lilienthal, Andor",297,289,586,,
"Kunte, Abhijit",296,290,586,,
"Yuffa, Daniil",284,301,585,,
"Ernst, Thomas",289,294,583,,
"Savic, Miodrag R.",306,277,583,,
"Dao, Thien Hai",304,278,582,,
"Opocensky, Karel",283,299,582,,
"Xu, Jun",288,294,582,,
"Vokac, Marek",281,301,582,,
"Plat, Vojtech",277,304,581,,
"Filippov, Valerij",293,288,581,,
"Rellstab, Ludwig Sr",290,291,581,,
"Gukesh, D.",288,292,580,,
"Vescovi, Giovanni P.",289,291,580,,
"Sermek, Drazen",301,278,579,,
"Tomczak, Jacek",292,286,578,,
"Tunik, Gennady",274,302,576,,
"Tseitlin, Mark D.",296,278,574,,
"Goldin, Alexander",293,281,574,,
"Danielsen, Henrik",277,297,574,,
"Garcia, Raimundo",290,283,573,,
"Plaskett, H. James",287,285,572,,
"Huschenbeth, Niclas",287,285,572,,
"Sadler, Matthew D.",283,287,570,,
"Mikenas, Vladas",274,295,569,,
"Pikula, Dejan",284,284,568,,
"Sanguinetti, Raul",296,271,567,,
"Romero Holmes, Alfonso",291,276,567,,
"Galliamova, Alisa",281,286,567,,
"Bobotsov, Milko G.",282,284,566,,
"Emms, John M.",297,268,565,,
"Mainka, Romuald",288,277,565,,
"Wen, Yang",271,294,565,,
"Aravindh, Chithambaram VR",283,282,565,,
"Shengelia, David",286,278,564,,
"Gareyev, Timur",282,282,564,,
"Nikolaidis, Ioannis",259,305,564,,
"Nataf, Igor-Alexandre",284,280,564,,
"Fogarasi, Tibor",274,290,564,,
"Giorgadze, Giorgi",277,286,563,,
"Onyshchuk, Volodymyr",282,281,563,,
"Reti, Richard",278,285,563,,
"Ligterink, Gert",291,271,562,,
"Vuckovic, Bojan",276,286,562,,
"Saric, Ante",276,286,562,,
"Tan, Zhongyi",281,280,561,,
"Nguyen, Thai Dai Van",290,271,561,,
"Prie, Eric",252,308,560,,
"Aseev, Konstantin N.",287,273,560,,
"Blagojevic, Dragisa",269,291,560,,
"Idani, Pouya",273,286,559,,
"Rozum, Ivan",278,281,559,,
"Schweber, Samuel",279,280,559,,
"Spasov, Vasil",284,275,559,,
"Gelashvili, Tamaz",291,268,559,,
"Shomoev, Anton",280,278,558,,
"Quesada Perez, Yuniesky",281,277,558,,
"Smagin, Sergey",283,275,558,,
"Sorokin, Maxim",287,271,558,,
"Berczes, David",279,278,557,,
"Lombardy, William J.",272,284,556,,
"Stupak, Kirill",274,282,556,,
"Galego, Luis",262,294,556,,
"Alsina Leal, Daniel",283,273,556,,
"Baramidze, David",267,288,555,,
"Gormally, Daniel W.",276,279,555,,
"Barua, Dibyendu",278,276,554,,
"Milic, Borislav",285,268,553,,
"Pashikian, Arman",278,275,553,,
"Gofshtein, Leonid",284,269,553,,
"Sanikidze, Tornike",285,268,553,,
"Pigusov, Evgeny",274,278,552,,
"Gereben, Erno",266,283,549,,
"Mastrovasilis, Athanasios",267,282,549,,
"Danielian, Elina",252,297,549,,
"Pogorelov, Ruslan",268,280,548,,
"Hoffman, Alejandro",264,283,547,,
"Garcia, Gildardo",285,262,547,,
"Hernandez Guerrero, Gilberto",276,270,546,,
"Fichtl, Jiri",283,263,546,,
"Evans, Larry M.",273,273,546,,
"Gruenfeld, Ernst",268,277,545,,
"Prohaszka, Peter",276,268,544,,
"Geetha, Narayanan Gopal",275,269,544,,
"Muzychuk, Mariya",279,265,544,,
"Xiong, Jeffery",280,263,543,,
"Anderssen, Adolf",265,278,543,,
"Gurgenidze, Bukhuti",283,260,543,,
"Grabarczyk, Miroslaw",257,284,541,,
"Antoshin, Vladimir S.",263,278,541,,
"Pietzsch, Wolfgang",272,268,540,,
"Cornette, Matthieu",281,259,540,,
"Udovcic, Mijo",271,268,539,,
"Chuchelov, Vladimir",275,264,539,,
"Pfleger, Helmut",266,272,538,,
"Thomas, George Alan",272,266,538,,
"Dragnev, Valentin",270,267,537,,
"Rogic, Davor",249,285,534,,
"Pelikan, Jorge",273,261,534,,
"Lastin, Alexander",278,255,533,,
"Maiwald, Jens-Uwe",271,261,532,,
"Nyzhnyk, Illya",280,251,531,,
"Neiksans, Arturs",278,253,531,,
"Hoi, Carsten",264,267,531,,
"Hoang, Thanh Trang",255,275,530,,
"Dzindzichashvili, Roman",276,254,530,,
"Dydyshko, Viacheslav",265,265,530,,
"Chernyshov, Konstantin",270,260,530,,
"Karthikeyan, Murali",267,262,529,,
"Almeida Quintana, Omar",256,273,529,,
"Capablanca, Jose",272,256,528,,
"Kuczynski, Robert",264,264,528,,
"Gashimov, Vugar",270,256,526,,
"Antal, Gergely",256,270,526,,
"Gabuzyan, Hovhannes",265,261,526,,
"Moehring, Guenther",263,263,526,,
"Todorcevic Antic, Miodrag",262,263,525,,
"Jovanic, Ognjen",263,262,525,,
"Knaak, Rainer FA",274,250,524,,
"Fercec, Nenad",246,278,524,,
"Dvirnyy, Danyyil",266,257,523,,
"Lintchevski, Daniil",264,259,523,,
"Sebenik, Matej",254,269,523,,
"Kovalevskaya, Ekaterina",249,273,522,,
"Bogner, Sebastian",276,246,522,,
"Tolush, Alexander V.",269,253,522,,
"Ricardi, Pablo",267,254,521,,
"Arizmendi Martinez, Julen Luis",261,260,521,,
"Karaklajic, Nikola",258,263,521,,
"Dgebuadze, Alexandre",242,279,521,,
"Steinitz, William",261,260,521,,
"Bertok, Mario",261,259,520,,
"Zhukova, Natalia",264,256,520,,
"Andersen, Mads",248,271,519,,
"Spiridonov, Nikolai",261,258,519,,
"Vladimirov, Yevgeniy",263,255,518,,
"McNab, Colin A.",241,276,517,,
"Vysochin, Spartak",260,257,517,,
"Teske, Henrik",277,240,517,,
"Puranik, Abhimanyu",253,263,516,,
"Vyzmanavin, Alexey",269,247,516,,
"Tisdall, Jonathan D.",265,250,515,,
"Berelowitsch, Alexander",264,251,515,,
"Prusikin, Michael",257,258,515,,
"Ushenina, Anna",254,260,514,,
"Barsov, Alexei",245,269,514,,
"Becerra Rivero, Julio",251,262,513,,
"Javakhishvili, Lela",248,265,513,,
"Hartston, William R.",256,257,513,,
"Moroni, Luca Jr",254,259,513,,
"Zueger, Beat",242,270,512,,
"Gausel, Einar J.",249,263,512,,
"Sulava, Nenad",268,244,512,,
"Kharitonov, Andrei V.",249,263,512,,
"Bai, Jinshi",258,254,512,,
"Mitkov, Nikola",253,258,511,,
"Dragun, Kamil",268,241,509,,
"Rodriguez Vargas, Orestes",264,244,508,,
"Cabrilo, Goran",261,247,508,,
"Winants, Luc",250,257,507,,
"Georgiev, Krum",223,283,506,,
"Pap, Misa",243,263,506,,
"Deepan, Chakkravarthy J.",242,263,505,,
"Kosintseva, Tatiana",261,243,504,,
"Efimov, Igor",235,267,502,,
"Kovacevic, Blazimir",260,242,502,,
"Ujtelky, Maximilian",247,255,502,,
"Kruppa, Yuri",258,243,501,,
"Shevchenko, Kirill",260,241,501,,
"Shishkin, Vadim",243,258,501,,
"Thorhallsson, Throstur",225,276,501,,
"Kollars, Dmitrij",244,257,501,,
"Arakhamia-Grant, Ketevan",257,243,500,,
"Jakobsen, Ole",256,244,500,,
"Maiorov, Nikita",248,251,499,,
"Sundararajan, Kidambi",242,256,498,,
"Mecking, Henrique",240,258,498,,
"Stellwagen, Daniel",251,246,497,,
"Vidmar, Milan Sr",245,251,496,,
"Dzhumaev, Marat",250,246,496,,
"Paragua, Mark",239,257,496,,
"Gonda, Laszlo",248,248,496,,
"Petrosian, Arshak B.",240,255,495,,
"Darga, Klaus",249,246,495,,
"Jovanovic, Zoran Z.",235,260,495,,
"Nikolov, Momchil",230,265,495,,
"Kotsur, Pavel",236,258,494,,
"Nimzowitsch, Aron",237,254,491,,
"Lasker, Emanuel",242,248,490,,
"Mednis, Edmar J.",246,244,490,,
"Slipak, Sergio",254,234,488,,
"Ipatov, Alexander",244,244,488,,
"Maksimenko, Andrei",247,241,488,,
"Baburin, Alexander",247,241,488,,
"Antoniewski, Rafal",217,270,487,,
"Medvegy, Zoltan",248,239,487,,
"Yates, Frederic D.",250,237,487,,
"Guliyev, Namig",238,249,487,,
"Cyborowski, Lukasz",253,234,487,,
"Djurhuus, Rune",244,243,487,,
"Ionov, Sergey",248,238,486,,
"King, Daniel J.",235,251,486,,
"Stean, Michael F.",258,228,486,,
"Neelotpal, Das",237,249,486,,
"Keymer, Vincent",246,240,486,,
"Brunner, Lucas",222,264,486,,
"Hug, Werner",218,267,485,,
"Vovk, Yuri",241,244,485,,
"Gledura, Benjamin",249,235,484,,
"Velicka, Petr",225,259,484,,
"Solozhenkin, Evgeniy",247,236,483,,
"Cori, Jorge",250,233,483,,
"Panchenko, Alexander N.",245,238,483,,
"Dziuba, Marcin",242,241,483,,
"Sebag, Marie Rachel",229,253,482,,
"Rivas Pastor, Manuel",243,239,482,,
"Fominyh, Alexander",242,240,482,,
"Fuchs, Reinhart",247,235,482,,
"Rychagov, Andrey",242,239,481,,
"Moradiabadi, Elshan",246,235,481,,
"Yagupov, Igor",246,234,480,,
"Zhu, Chen",250,230,480,,
"Petkov, Vladimir",236,243,479,,
"Polgar, Zsuzsa",243,236,479,,
"Bukic, Enver",230,249,479,,
"Paunovic, Dragan",230,248,478,,
"Poluljahov, Aleksandr",239,238,477,,
"Lutikov, Anatoly S.",260,217,477,,
"Davies, Nigel R.",240,236,476,,
"Pogonina, Natalija",246,229,475,,
"Pridorozhni, Aleksei",227,248,475,,
"Velikov, Petar V.",233,242,475,,
"Frolyanov, Dmitry",235,240,475,,
"Szmetan, Jorge",235,240,475,,
"Van Riemsdijk, Herman C.",245,230,475,,
"Hauchard, Arnaud",235,240,475,,
"Milanovic, Danilo",231,243,474,,
"Ivic, Velimir",227,247,474,,
"Maletin, Pavel",248,226,474,,
"Teichmann, Richard",231,242,473,,
"Xu, Xiangyu",241,231,472,,
"Lehmann, Heinz",225,245,470,,
"Cherniaev, Alexander",228,242,470,,
"Sargsyan, Shant",232,238,470,,
"Wagner, Dennis",233,236,469,,
"Zubov, Alexander",240,229,469,,
"Adianto, Utut",229,240,469,,
"Galkin, Alexander",224,244,468,,
"Hartoch, Robert G.",234,234,468,,
"Gomez Esteban, Juan Mario",231,236,467,,
"Zubarev, Alexander",227,240,467,,
"Ionescu, Constantin",246,221,467,,
"Planinec, Albin",232,235,467,,
"Antic, Dejan",237,229,466,,
"Kjartansson, Gudmundur",238,227,465,,
"Urkedal, Frode Olav Olsen",241,223,464,,
"Asrian, Karen",236,228,464,,
"Spassov, Liuben",227,237,464,,
"Manolache, Marius",222,241,463,,
"Matamoros Franco, Carlos S.",222,241,463,,
"Jakubowski, Krzysztof",233,230,463,,
"Gaprindashvili, Nona",235,228,463,,
"Haag, Ervin",230,233,463,,
"Yevseev, Denis",250,213,463,,
"Roeder, Matthias",210,253,463,,
"Sergeev, Vladimir",237,225,462,,
"Yandemirov, Valeri",204,257,461,,
"Ramirez Alvarez, Alejandro",230,231,461,,
"Gonzalez Vidal, Yuri",232,229,461,,
"Girya, Olga",234,226,460,,
"Iskusnyh, Sergei",221,239,460,,
"Hausner, Ivan",228,232,460,,
"Rowson, Jonathan",223,237,460,,
"Yurtaev, Leonid",241,219,460,,
"Gharamian, Tigran",242,218,460,,
"Kacheishvili, Giorgi",238,221,459,,
"Zaichik, Gennadi",244,214,458,,
"Ostojic, Predrag",238,220,458,,
"Chabanon, Jean-Luc",234,224,458,,
"Hernandez Onna, Roman",206,251,457,,
"Bondarevsky, Igor",228,229,457,,
"Schussler, Harry",210,246,456,,
"Tolnai, Tibor",219,237,456,,
"De la Villa Garcia, Jesus Maria",230,226,456,,
"Lugovoi, Aleksei",223,232,455,,
"Oral, Tomas",229,226,455,,
"San Segundo Carrillo, Pablo",223,231,454,,
"Lazic, Miroljub",217,237,454,,
"Krogius, Nikolai V.",213,241,454,,
"Shcherbakov, Ruslan",236,217,453,,
"Sindarov, Javokhir",228,225,453,,
"Mekhitarian, Krikor Sevag",232,221,453,,
"Levin, Felix",202,249,451,,
"Stoltz, Goesta",234,216,450,,
"Yakubboev, Nodirbek",217,232,449,,
"Dardha, Daniel",229,220,449,,
"Zhou, Weiqi",231,218,449,,
"Todorovic, Goran M.",217,232,449,,
"Pytel, Krzysztof",225,224,449,,
"Pruijssers, Roeland",230,218,448,,
"Puc, Stojan",225,223,448,,
"Slobodjan, Roman",206,242,448,,
"Vaulin, Alexander",232,216,448,,
"Tarjan, James E.",218,227,445,,
"Foguelman, Alberto",227,217,444,,
"Williams, Simon K.",217,227,444,,
"Komljenovic, Davorin",215,228,443,,
"Papaioannou, Ioannis",213,230,443,,
"Kritz, Leonid",221,221,442,,
"Makarichev, Sergey",216,226,442,,
"Mason, James",224,216,440,,
"Gabrielian, Artur",218,222,440,,
"Batsiashvili, Nino",211,229,440,,
"Markos, Jan",232,208,440,,
"Hoffmann, Michael",204,236,440,,
"Shariyazdanov, Andrey",213,227,440,,
"Sumets, Andrey",222,217,439,,
"Perez Candelario, Manuel",218,221,439,,
"Alonso Rosell, Alvar",221,217,438,,
"Mokry, Karel",205,233,438,,
"Zherebukh, Yaroslav",220,217,437,,
"Kozma, Julius",228,209,437,,
"Gabriel, Christian",225,212,437,,
"Ivanov, Igor V.",205,232,437,,
"Mohr, Georg",209,227,436,,
"Hellers, Ferdinand",236,200,436,,
"Xu, Yinglun",216,218,434,,
"Khotenashvili, Bella",219,215,434,,
"Ye, Jiangchuan",222,212,434,,
"Schmid, Lothar",223,210,433,,
"Flesch, Janos",210,222,432,,
"Ciric, Dragoljub M.",223,209,432,,
"Ortiz Suarez, Isan Reynaldo",210,222,432,,
"Kryakvin, Dmitry",216,216,432,,
"Zontakh, Andrey",234,197,431,,
"Xie, Jun",216,215,431,,
"Braun, Arik",219,212,431,,
"Maderna, Carlos Hugo",215,216,431,,
"Cuenca Jimenez, Jose Fernando",224,206,430,,
"Penrose, Jonathan",219,211,430,,
"Iljiushenok, Ilia",198,232,430,,
"Murzin, Volodar",217,212,429,,
"Bolbochan, Julio",217,212,429,,
"Sadhwani, Raunak",223,206,429,,
"Cernousek, Lukas",222,205,427,,
"Shneider, Aleksandr",211,216,427,,
"Kuljasevic, Davorin",222,205,427,,
"Prins, Lodewijk",213,213,426,,
"Vazquez Igarza, Renier",212,214,426,,
"Bindrich, Falko",210,216,426,,
"Cmilyte, Viktorija",206,220,426,,
"Steiner, Lajos",218,208,426,,
"Van Foreest, Lucas",208,218,426,,
"Serper, Grigory",207,218,425,,
"Bolbochan, Jacobo",216,209,425,,
"Geller, Jakov",211,213,424,,
"Jenni, Florian",201,223,424,,
"Smith, Axel",213,210,423,,
"Kagan, Shimon",209,214,423,,
"Belov, Vladimir",221,202,423,,
"Filipowicz, Andrzej",207,215,422,,
"Heimann, Andreas",203,219,422,,
"Bobras, Piotr",205,215,420,,
"Johannessen, Leif Erlend",203,216,419,,
"Stojanovic, Mihajlo",191,228,419,,
"Lima, Darcy",206,213,419,,
"Meshkovs, Nikita",194,225,419,,
"Szilagyi, Gyorgy",207,211,418,,
"Goloshchapov, Alexander",217,201,418,,
"Popovic, Dusan",217,201,418,,
"Gasanov, Eldar",203,214,417,,
"Arlandi, Ennio",218,199,417,,
"Shaposhnikov, Evgeny",211,206,417,,
"Antonio, Rogelio Jr",213,203,416,,
"Saltaev, Mihail",202,214,416,,
"Bezold, Michael",192,224,416,,
"Meijers, Viesturs",213,202,415,,
"Marovic, Drazen",197,218,415,,
"Bogosavljevic, Boban",216,199,415,,
"Krejci, Jan",211,203,414,,
"Hausrath, Daniel",192,222,414,,
"Zhang, Pengxiang",212,202,414,,
"Hennings, Artur",204,209,413,,
"Skripchenko, Almira",188,225,413,,
"Markovic, Miroslav",199,214,413,,
"Nikolac, Juraj",207,205,412,,
"Thipsay, Praveen M.",209,203,412,,
"Vokhidov, Shamsiddin",213,199,412,,
"Wexler, Bernardo",200,211,411,,
"Leonhardt, Paul S.",204,207,411,,
"Zinn, Lothar",216,195,411,,
"Vasquez Schroeder, Rodrigo",196,215,411,,
"Marco, Georg",200,210,410,,
"Kostro, Jerzy",221,189,410,,
"Tosic, Miroslav",207,203,410,,
"Rukavina, Josip",175,235,410,,
"Rabar, Braslav",210,200,410,,
"Shyam, Sundar M.",203,206,409,,
"Miralles, Gilles",197,212,409,,
"Wirthensohn, Heinz",203,206,409,,
"Stangl, Markus",207,202,409,,
"Li, Shilong",194,214,408,,
"Grivas, Efstratios",205,203,408,,
"Minev, Nikolay N.",192,215,407,,
"Pechac, Jergus",209,198,407,,
"Popov, Luben Stojanov",184,222,406,,
"Nguyen, Anh Dung",205,201,406,,
"Mestrovic, Zvonimir",189,217,406,,
"Megaranto, Susanto",196,210,406,,
"De la Riva Aguado, Oscar",206,200,406,,
"Kovalyov, Anton",203,202,405,,
"Vadasz, Laszlo",202,203,405,,
"Jakubiec, Artur",195,210,405,,
"Bosboom, Manuel",211,193,404,,
"Naumann, Alexander",189,215,404,,
"Gruenberg, Hans-Ulrich",198,206,404,,
"Grigore, George-Gabriel",202,202,404,,
"Sadzikowski, Daniel",196,208,404,,
"Al-Mudahka, Mohd",216,188,404,,
"Kuijf, Marinus",181,222,403,,
"Mamedov, Nidjat",204,199,403,,
"Polzin, Rainer",207,196,403,,
"Brenjo, Slavisa",193,210,403,,
"Ward, Chris G.",204,198,402,,
"Garcia Gonzales, Guillermo",191,209,400,,
"Basso, Pier Luigi",193,207,400,,
"Lisitsin, Georgy",196,204,400,,
"Valerga, Diego",194,206,400,,
"Nikcevic, Nebojsa",193,207,400,,
"Ostenstad, Berge",207,193,400,,
"Kasparov, Sergey",187,213,400,,
"Alterman, Boris",203,196,399,,
"Hernandez Carmenate, Holden",202,197,399,,
"Izoria, Zviad",201,198,399,,
"Yanofsky, Daniel Abraham",207,192,399,,
"Izeta Txabarri, Felix",200,199,399,,
"Handke, Florian",198,201,399,,
"Murshed, Niaz",200,198,398,,
"Cobo Arteaga, Eldis",191,206,397,,
"Kirov, Nino",203,194,397,,
"Bogdanovic, Rajko",196,201,397,,
"Stripunsky, Alexander",199,198,397,,
"Jimenez Zerquera, Eleazar",185,210,395,,
"Ekstroem, Roland",193,202,395,,
"Venkatesh, Marani Rajendran",212,183,395,,
"Shanava, Konstantine",180,214,394,,
"Nemet, Ivan",195,199,394,,
"Hera, Imre Jr",210,183,393,,
"Belous, Vladimir",205,188,393,,
"Rossolimo, Nicolas",185,207,392,,
"Watson, William N.",175,216,391,,
"Corrales Jimenez, Fidel",207,184,391,,
"Hakobyan, Aram",200,191,391,,
"Schneider, Lars-Ake",200,191,391,,
"Foltys, Jan",190,199,389,,
"Nei, Iivo",196,192,388,,
"Erenburg, Sergey",194,194,388,,
"Zeng, Chongsheng",196,192,388,,
"Alatortsev, Vladimir",192,196,388,,
"Toran Albero, Roman",190,198,388,,
"Beshukov, Sergei",189,199,388,,
"Gretarsson, Helgi Ass",195,192,387,,
"Pacher, Milan",195,192,387,,
"Zaja, Ivan",176,210,386,,
"Esen, Baris",189,197,386,,
"Ovetchkin, Roman",190,196,386,,
"Zagrebelny, Sergey",201,185,386,,
"Malisauskas, Vidmantas",188,198,386,,
"Rabiega, Robert",186,200,386,,
"Harutyunyan, Tigran K.",187,198,385,,
"Kochyev, Alexander V.",177,207,384,,
"Gumularz, Szymon",200,184,384,,
"Komarov, Dimitri",196,187,383,,
"Fries-Nielsen, Jens Ove",180,203,383,,
"Le Roux, Jean-Pierre",171,211,382,,
"Kashlinskaya, Alina",195,187,382,,
"Radulski, Julian",201,181,382,,
"Cruz, Cristhian",187,194,381,,
"Burg, Twan",179,202,381,,
"Sorin, Ariel",192,189,381,,
"Relange, Eloi",150,231,381,,
"Urban, Klaudiusz",171,210,381,,
"Kottnauer, Cenek",186,195,381,,
"Makarov, Marat",203,178,381,,
"Kozak, Adam",190,190,380,,
"Warmerdam, Max",194,186,380,,
"Kan, Ilya A.",187,193,380,,
"Libiszewski, Fabien",196,183,379,,
"Kramer, Haije",192,187,379,,
"Hamann, Svend",181,197,378,,
"Mendonca, Leon Luke",190,188,378,,
"Rasmussen, Allan Stig",192,186,378,,
"Kotanjian, Tigran",199,178,377,,
"Kosintseva, Nadezhda",196,181,377,,
"Luckis, Marcos",187,190,377,,
"Van Kampen, Robin",187,190,377,,
"Kolev, Atanas Tonchev",195,181,376,,
"Firman, Nazar",198,178,376,,
"Rasik, Vitezslav",183,193,376,,
"Aczel, Gergely",193,182,375,,
"Ma, Qun",189,186,375,,
"Cvek, Robert",179,196,375,,
"Lazarev, Vladimir",179,196,375,,
"Paichadze, Luka",201,174,375,,
"Osnos, Viatcheslav",185,190,375,,
"Witkowski, Stefan",183,192,375,,
"Clarke, Peter H.",180,194,374,,
"Danner, Georg",182,192,374,,
"Bricard, Emmanuel",187,187,374,,
"Zilka, Stepan",200,173,373,,
"Cuellar Gacharna, Miguel",178,195,373,,
"Nasuta, Grzegorz",178,194,372,,
"Kantans, Toms",179,193,372,,
"Arutinian, David",184,188,372,,
"Abergel, Thal",188,183,371,,
"Bird, Henry Edward",186,183,369,,
"Bjerre, Jonas Buhl",192,176,368,,
"Steiner, Herman",176,191,367,,
"Comas Fabrego, Lluis",171,196,367,,
"Lokvenc, Josef",181,186,367,,
"Nagy, Gabor",179,187,366,,
"Atlas, Valery",191,174,365,,
"Friedel, Joshua E.",187,177,364,,
"Guliev, Sarhan",179,185,364,,
"Arbakov, Valentin",175,189,364,,
"Bohm, Hans",179,185,364,,
"Hansen, Eric",191,172,363,,
"Lobanov, Sergei",181,182,363,,
"Aronin, Lev",179,184,363,,
"Haznedaroglu, Kivanc",187,176,363,,
"Spangenberg, Hugo",191,172,363,,
"Fernandez Garcia, Jose Luis",176,187,363,,
"Pogats, Jozsef",188,175,363,,
"Szily, Jozsef",182,181,363,,
"Al-Sayed, Mohammed N.",179,184,363,,
"Rasulov, Vugar",184,178,362,,
"Borges Matos, Juan",170,192,362,,
"Papin, Vasily",170,191,361,,
"Emma, Jaime",184,177,361,,
"Chandra, Akshat",180,181,361,,
"Borisek, Jure",170,190,360,,
"Kostic, Boris",172,188,360,,
"Muse, Mladen",179,181,360,,
"Knezevic, Milorad",169,190,359,,
"Bezgodov, Alexei",186,173,359,,
"Quparadze, Giga",185,174,359,,
"Petrov, Nikita",188,171,359,,
"Stremavicius, Titas",172,187,359,,
"Haik, Aldo",189,169,358,,
"Tikkanen, Hans",182,176,358,,
"Steingrimsson, Hedinn",186,171,357,,
"Jirovsky, Milos",166,191,357,,
"Mueller, Karsten",189,167,356,,
"Wirig, Anthony",165,191,356,,
"Gavrilov, Alexei",174,182,356,,
"Dueckstein, Andreas",182,174,356,,
"Nanu, Costica-Ciprian",170,186,356,,
"Laurusas, Tomas",171,184,355,,
"Campos Moreno, Javier B.",179,176,355,,
"Kieninger, Georg",179,176,355,,
"Bakre, Tejas",160,195,355,,
"Colle, Edgar",178,177,355,,
"Barle, Janez",174,180,354,,
"Bannik, Anatoly",183,171,354,,
"Petrov, Marian",172,181,353,,
"Nedev, Trajko",184,169,353,,
"Lei, Tingjie",182,171,353,,
"Wan, Yunguo",176,177,353,,
"Cubas, Jose Fernando",185,168,353,,
"Mueller, Hans Georg",175,177,352,,
"Kraemer, Martin",172,180,352,,
"Hamitevici, Vladimir",161,191,352,,
"Iuldachev, Saidali",172,180,352,,
"Pert, Nicholas",173,178,351,,
"Kantor, Gergely",176,175,351,,
"Blatny, Frantisek",171,180,351,,
"Gordievsky, Dmitry",167,184,351,,
"Janssen, Ruud",171,179,350,,
"Giorgadze, Tamaz",178,171,349,,
"Leon Hoyos, Manuel",174,175,349,,
"Prandstetter, Eduard",170,178,348,,
"Bagaturov, Giorgi",161,187,348,,
"Mihok, Oliver",175,173,348,,
"Kuijpers, Franciscus Antonius",170,178,348,,
"Gozzoli, Yannick",167,181,348,,
"Vakhidov, Jakhongir",175,173,348,,
"Christiansen, Johan-Sebastian",165,183,348,,
"Cvetkovic, Srdjan",167,181,348,,
"Mariotti, Sergio",166,181,347,,
"Golz, Werner",165,182,347,,
"Petr, Martin",181,166,347,,
"Toth, Bela",180,167,347,,
"Levenfish, Grigory",174,172,346,,
"Rusev, Krasimir",170,176,346,,
"Tazbir, Marcin",171,175,346,,
"Deviatkin, Andrei",175,171,346,,
"Korotylev, Alexey",171,175,346,,
"Foisor, Ovidiu-Doru",158,188,346,,
"Saidy, Anthony F.",157,188,345,,
"Gerusel, Mathias",187,158,345,,
"Feller, Sebastien",188,157,345,,
"Petrik, Tomas",170,175,345,,
"Sahovic, Dragutin",183,162,345,,
"Kraidman, Yair",163,182,345,,
"Lajthajm, Borko",168,176,344,,
"Thybo, Jesper Sondergaard",164,180,344,,
"Shirazi, Kamran",161,183,344,,
"Jianu, Vlad-Cristian",171,173,344,,
"Bromberger, Stefan",180,164,344,,
"Moranda, Wojciech",174,169,343,,
"Warakomski, Tomasz",174,169,343,,
"Boros, Denes",165,178,343,,
"Vovk, Andriy",180,163,343,,
"Munoz Pantoja, Miguel",156,187,343,,
"Fontaine, Robert",161,181,342,,
"Zakhartsov, Viacheslav V.",166,176,342,,
"Stukopin, Andrey",169,173,342,,
"Burn, Amos",172,170,342,,
"Livaic, Leon",176,165,341,,
"Iljushin, Alexei",159,182,341,,
"Liang, Awonder",173,168,341,,
"Feygin, Michael",167,174,341,,
"Ogaard, Leif",176,164,340,,
"Sadvakasov, Darmen",178,162,340,,
"Zuidema, Coenraad",168,172,340,,
"Kallai, Gabor",159,180,339,,
"Carlsson, Pontus",159,180,339,,
"Petran, Pal",164,175,339,,
"Raetsky, Alexander",148,191,339,,
"Santos Ruiz, Miguel",175,164,339,,
"Flom, Gabriel",175,164,339,,
"Baron, Tal",166,172,338,,
"Magerramov, Elmar",169,169,338,,
"Stojanovic, Dalibor",166,171,337,,
"Ghinda, Mihail-Viorel",190,147,337,,
"Aryan, Chopra",174,163,337,,
"Levin, Evgeny A.",158,179,337,,
"Shen, Yang",169,167,336,,
"Starostits, Ilmars",149,187,336,,
"Tukhaev, Adam",177,159,336,,
"Grigoryan, Avetik",176,160,336,,
"Blohberger, Felix",162,173,335,,
"Novikov, Stanislav",172,163,335,,
"Duras, Oldrich",167,168,335,,
"Perelshteyn, Eugene",169,166,335,,
"Swinkels, Robin",172,163,335,,
"Lukin, Andrei M.",172,163,335,,
"Dlugy, Maxim",172,162,334,,
"Siebrecht, Sebastian",178,156,334,,
"Bernasek, Jan",152,182,334,,
"Rajlich, Iweta",182,152,334,,
"Turner, Matthew J.",153,180,333,,
"Podgaets, Mikhail",162,170,332,,
"Diermair, Andreas",171,161,332,,
"Raicevic, Vladimir",167,164,331,,
"Ovsejevitsch, Sergei",181,150,331,,
"Martinez Duany, Lelys Stanley",165,166,331,,
"Li, Di",159,172,331,,
"Jonkman, Harmen",155,176,331,,
"Suleymanli, Aydin",169,161,330,,
"Showalter, Jackson",168,162,330,,
"Theodorou, Nikolas",173,157,330,,
"Estrin, Yakov",169,161,330,,
"Karthik, Venkataraman",173,157,330,,
"Pillsbury, Harry",166,163,329,,
"Cao, Sang",165,164,329,,
"Golubev, Mikhail",159,170,329,,
"Arsovic, Zoran",150,179,329,,
"Enders, Peter",170,158,328,,
"Reinhardt, Enrique",155,172,327,,
"Grigorian, Karen A.",162,164,326,,
"Gonzalez Garcia, Jose",162,164,326,,
"Zeitlein, Michael",167,159,326,,
"Zita, Frantisek",163,163,326,,
"Sprenger, Jan Michael",173,152,325,,
"Konopka, Michal",153,172,325,,
"Nestorovic, Nikola",168,157,325,,
"Koch, Jean-Rene",162,163,325,,
"Suttles, Duncan",162,162,324,,
"Babujian, Levon",160,164,324,,
"Dumitrache, Dragos-Nicolae",154,170,324,,
"Hayrapetyan, Hovik",154,169,323,,
"Vishnu, Prasanna V.",171,152,323,,
"Matsuura, Everaldo",160,163,323,,
"Popchev, Milko",152,171,323,,
"Debashis, Das",163,160,323,,
"Shipov, Sergei",154,168,322,,
"Teschner, Rudolf",162,160,322,,
"Manik, Mikulas",153,169,322,,
"Zarnicki, Pablo",167,154,321,,
"Arnaudov, G. Petar",174,147,321,,
"Danin, Alexandre",163,158,321,,
"Perez Perez, Francisco",153,167,320,,
"Nemeth, Miklos1",157,163,320,,
"Beni, Alfred",162,158,320,,
"Zatonskih, Anna",150,170,320,,
"Kiselev, Sergey",145,174,319,,
"Krysa, Leandro",150,169,319,,
"Heinemann, Thies",157,162,319,,
"Panchanathan, Magesh Chandran",166,153,319,,
"Soppe, Guillermo",151,168,319,,
"Keitlinghaus, Ludger",155,164,319,,
"Krivoshey, Sergei",158,161,319,,
"Jurcik, Marian",158,161,319,,
"Hellsten, Johan",152,166,318,,
"Enevoldsen, Jens",159,159,318,,
"Beerdsen, Thomas",150,168,318,,
"Balcerowski, Witold",157,161,318,,
"Rogulj, Branko",145,173,318,,
"Szabo, Krisztian",164,154,318,,
"Chirila, Ioan-Cristian",160,157,317,,
"Repka, Christopher",164,153,317,,
"Tompa, Janos",152,165,317,,
"Perez Ponsa, Federico",178,138,316,,
"Vilela de Acuna, Jose Luis",153,163,316,,
"Henriquez Villagra, Cristobal",164,152,316,,
"Polgar, Sofia",156,159,315,,
"Cicak, Slavko",155,160,315,,
"Kantsler, Boris",132,182,314,,
"Zoler, Dan",154,160,314,,
"Drozdovskij, Yuri",153,161,314,,
"Tadic, Branko",149,165,314,,
"Womacka, Mathias",161,152,313,,
"Iotov, Valentin",160,153,313,,
"Mkrtchian, Lilit",154,159,313,,
"Arkhipov, Sergey G.",151,161,312,,
"Ioseliani, Nana",160,152,312,,
"Shyaamnikhil, P.",157,155,312,,
"Karttunen, Mika",154,158,312,,
"Ristic, Nenad",144,167,311,,
"Zambrana, Oswaldo",166,145,311,,
"Laylo, Darwin",158,152,310,,
"Ivanov, Mikhail M.",154,156,310,,
"Cuartas, Carlos",152,158,310,,
"Georgiadis, Nico",152,158,310,,
"Gonzalez Zamora, Juan Carlos",164,146,310,,
"Oms Pallisse, Josep",153,157,310,,
"Michiels, Bart",160,150,310,,
"Bellahcene, Bilel",159,150,309,,
"Nesterov, Arseniy",159,150,309,,
"Asis Gargatagli, Hipolito",150,159,309,,
"Paulsen, Louis",150,159,309,,
"Diaz Diaz, Joaquin Carlos",158,151,309,,
"Ali Marandi, Cemil Can",154,155,309,,
"Johner, Paul F.",153,156,309,,
"Kalinitschew, Sergey",146,162,308,,
"Janik, Igor",150,158,308,,
"Skoberne, Jure",149,159,308,,
"Druska, Juraj",150,157,307,,
"Johansen, Darryl K.",153,154,307,,
"Michel, Paul",161,145,306,,
"Boruchovsky, Avital",147,159,306,,
"Sonis, Francesco",149,157,306,,
"Camara, Helder",150,155,305,,
"Hazai, Laszlo",143,162,305,,
"Grosar, Aljosa",152,153,305,,
"Eising, Johannes",154,151,305,,
"Durao, Joaquim",161,144,305,,
"Johannessen, Svein",148,157,305,,
"Kornev, Alexei",148,156,304,,
"Badea, Bela",141,163,304,,
"Khachiyan, Melikset",157,146,303,,
"Bellin, Robert Cecil",156,147,303,,
"Mikaelyan, Arman",156,147,303,,
"Seres, Lajos",145,158,303,,
"Kapengut, Albert Z.",158,145,303,,
"Paehtz, Thomas",140,163,303,,
"Yrjola, Jouni",144,159,303,,
"Mazur, Stefan",153,149,302,,
"Legky, Nikolay A.",147,155,302,,
"Lundin, Erik",148,154,302,,
"Fodor, Tamas Jr",149,153,302,,
"Gunsberg, Isidor",149,153,302,,
"Liu, Yan",143,158,301,,
"Szekely, Peter",115,186,301,,
"Ortega, Lexy",133,168,301,,
"Xiu, Deshun",152,149,301,,
"Gaponenko, Inna",140,161,301,,
"Larino Nieto, David",152,148,300,,
"Sambuev, Bator",154,146,300,,
"Plater, Kazimierz",139,161,300,,
"Van der Weide, Karel",159,141,300,,
"Laxman, Rajaram R.",145,154,299,,
"Gomez, John Paul",146,153,299,,
"Gretarsson, Hjorvar Steinn",157,142,299,,
"Olszewski, Michal",150,149,299,,
"Cuartas, Jaime Alexander",140,159,299,,
"Biyiasas, Peter",151,148,299,,
"Bukavshin, Ivan",147,151,298,,
"Zukertort, Johannes H.",152,146,298,,
"Soffer, Ram",159,139,298,,
"Aditya, Mittal",150,148,298,,
"Dervishi, Erald",149,148,297,,
"Rechlis, Gad",152,145,297,,
"Erdogdu, Mert",153,144,297,,
"Diez del Corral, Jesus",153,144,297,,
"Naroditsky, Daniel",148,149,297,,
"Agopov, Mikael",144,152,296,,
"Kouatly, Bachar",146,150,296,,
"Korpa, Bence",150,146,296,,
"Sychev, Klementy",155,141,296,,
"Wolff, Patrick G.",148,148,296,,
"Gershon, Alik",147,149,296,,
"Dobrov, Vladimir",155,141,296,,
"Filippov, Anton",152,143,295,,
"Horvath, Tamas",136,159,295,,
"Fine, Reuben",138,157,295,,
"Itkis, Boris",146,149,295,,
"Wang, Chen",152,143,295,,
"Kashdan, Isaac",147,148,295,,
"Zakhartsov, Vladimir",137,158,295,,
"Lou, Yiping",144,151,295,,
"Kalod, Radek",142,153,295,,
"Vaibhav, Suri",145,149,294,,
"Prasad, Devaki V.",143,151,294,,
"Biolek, Richard",141,153,294,,
"Harsha, Bharathakoti",148,146,294,,
"Bronstein, Luis Marcos",145,148,293,,
"Dimitrov, Radoslav",150,143,293,,
"Bokros, Albert",154,139,293,,
"Batchuluun, Tsegmed",154,139,293,,
"Herrera, Irisberto",136,157,293,,
"Troianescu, Octav",139,154,293,,
"Casper, Thomas",123,170,293,,
"Kurmann, Oliver",133,160,293,,
"Aroshidze, Levan",146,146,292,,
"Alexander, Conel Hughes",151,141,292,,
"Stanec, Nikolaus",124,168,292,,
"Gazik, Viktor",150,142,292,,
"Anic, Darko",149,143,292,,
"Pultinevicius, Paulius",139,153,292,,
"Ismagambetov, Anuar",139,153,292,,
"Brinck-Claussen, Bjorn",146,146,292,,
"Finegold, Benjamin",139,152,291,,
"De Souza Mendes, Joao",146,144,290,,
"Karpatchev, Aleksandr",128,162,290,,
"Firat, Burak",146,144,290,,
"Demuth, Adrien",148,142,290,,
"Barbero, Gerardo F.",142,148,290,,
"Xu, Yi",142,148,290,,
"Czarnota, Pawel",139,151,290,,
"Kislinsky, Alexey",143,147,290,,
"Augustin, Josef",150,140,290,,
"Vokarev, Sergey",166,123,289,,
"Likavsky, Tomas",150,139,289,,
"Veingold, Aleksandr",131,158,289,,
"Marciano, David",137,152,289,,
"Borisenko, Georgy K.",150,138,288,,
"Enklaar, Bertus F.",146,142,288,,
"Shuvalova, Polina",143,145,288,,
"Sakharov, Yuri N.",142,146,288,,
"Ashwin, Jayram",144,144,288,,
"Kanarek, Marcel",135,153,288,,
"Zilberman, Yaacov",140,148,288,,
"Meins, Gerlef",139,149,288,,
"Giardelli, Sergio C.",143,144,287,,
"Chistiakov, Alexander N.",137,150,287,,
"Jansson, Borje",155,132,287,,
"Harutjunyan, Gevorg",131,156,287,,
"Quesada Perez, Yasser",137,150,287,,
"Lie, Kjetil A.",154,133,287,,
"Swapnil, S. Dhopade",140,146,286,,
"Khasin, Abram",144,142,286,,
"Braga, Fernando",136,150,286,,
"Semcesen, Daniel",126,160,286,,
"Belotti, Bruno",143,143,286,,
"Chekhover, Vitaly",144,142,286,,
"Pritchett, Craig W.",148,138,286,,
"Oratovsky, Michael",139,147,286,,
"Nicevski, Risto",135,150,285,,
"Volke, Karsten",137,148,285,,
"Alapin, Simon",145,140,285,,
"Kraus, Tomas",145,140,285,,
"Kuligowski, Adam",149,136,285,,
"Perez Mitjans, Orelvis",145,139,284,,
"Komliakov, Viktor",137,147,284,,
"Wolf, Heinrich",145,138,283,,
"Fishbein, Alexander",138,145,283,,
"Richter, Kurt P.",143,140,283,,
"Becker, Albert",144,139,283,,
"Sriram, Jha",134,149,283,,
"Atalik, Ekaterina",138,144,282,,
"Lesiege, Alexandre",147,135,282,,
"Mrva, Martin",144,138,282,,
"Sepp, Olav",139,143,282,,
"Kinnmark, Ove",132,150,282,,
"Sydor, Andrzej",142,140,282,,
"Klinger, Josef",138,144,282,,
"Dimitrov, Vladimir",142,139,281,,
"Nezhmetdinov, Rashid",144,137,281,,
"Portisch, Ferenc",125,156,281,,
"Studer, Noel",143,138,281,,
"Landenbergue, Claude",130,150,280,,
"Gao, Rui",141,139,280,,
"Dokhoian, Yury",143,137,280,,
"Bodnaruk, Anastasia",142,137,279,,
"Platonov, Igor V.",138,141,279,,
"Motwani, Paul",140,139,279,,
"Sharif, Mehrshad",118,161,279,,
"Bykhovsky, Avigdor",132,146,278,,
"Kazakouski, Valery",132,146,278,,
"Voitsekhovsky, Stanislav",141,137,278,,
"Okhotnik, Vladimir",131,147,278,,
"Bielicki, Carlos",140,138,278,,
"Rohde, Michael A.",143,134,277,,
"Volzhin, Alexander",138,139,277,,
"Iniyan, Pa",131,146,277,,
"Ibarra Jerez, Jose Carlos",140,137,277,,
"Alster, Ladislav",140,137,277,,
"Bouwmeester, Hans",141,136,277,,
"Visakh, NR",134,143,277,,
"Cherepkov, Alexander V.",140,136,276,,
"Zakharevich, Igor",130,146,276,,
"Flumbort, Andras",141,135,276,,
"Fernandes, Antonio",140,136,276,,
"Appel, Ralf",138,138,276,,
"Baryshpolets, Andrey",128,147,275,,
"Sajtar, Jaroslav",132,143,275,,
"Murdzia, Piotr",136,138,274,,
"Riff, Jean-Noel",127,147,274,,
"Marcelin, Cyril",124,150,274,,
"Giaccio, Alfredo",141,133,274,,
"Annaberdiyev, Meylis",132,142,274,,
"Kanep, Meelis",134,138,272,,
"Panov, Vasily",136,136,272,,
"Genov, Petar",119,152,271,,
"Tsydypov, Zhamsaran",129,142,271,,
"Janev, Evgeni",142,129,271,,
"Hebert, Jean",139,132,271,,
"Horvath, Dominik",141,129,270,,
"Peev, Peicho",135,135,270,,
"Benko, Francisco",133,137,270,,
"Bogdanovski, Vlatko",140,130,270,,
"Stanojoski, Zvonko",135,134,269,,
"Maurizzi, Marc'Andria",135,134,269,,
"Borovikov, Vladislav",148,121,269,,
"Kostenko, Petr",137,132,269,,
"Salwe, Georg",135,134,269,,
"Galdunts, Sergey",125,144,269,,
"Palatnik, Semon",121,148,269,,
"Sammalvuo, Tapani",122,146,268,,
"Tran, Tuan Minh",128,140,268,,
"Vykouk, Jan",132,136,268,,
"Makarian, Rudik",127,140,267,,
"Abreu Delgado, Aryam",129,138,267,,
"Bluvshtein, Mark",140,127,267,,
"Jacobson, Brandon",132,135,267,,
"Mochalov, Evgeny V.",134,132,266,,
"Albornoz Cabrera, Carlos Daniel",130,136,266,,
"Spoelman, Wouter",127,139,266,,
"Bernstein, Ossip",131,135,266,,
"Maric, Alisa",127,139,266,,
"Muradli, Mahammad",124,141,265,,
"Rabinovich, Ilya L.",130,135,265,,
"Schmaltz, Roland",125,140,265,,
"Vorotnikov, Vladislav V.",122,143,265,,
"Grover, Sahaj",133,132,265,,
"Meister, Jakob",137,127,264,,
"Hossain, Enamul",137,127,264,,
"Antunes, Antonio",140,124,264,,
"Voloshin, Leon",120,144,264,,
"Pfeiffer, Gerhard",137,126,263,,
"Szabo, Gergely-Andras-Gyula",118,145,263,,
"Hess, Robert L.",129,134,263,,
"Klekowski, Maciej",132,131,263,,
"Valsecchi, Alessio",126,136,262,,
"Arun Prasad, S.",127,135,262,,
"Fuderer, Andrija",128,134,262,,
"Elsness, Frode",128,134,262,,
"Darini, Pouria",128,134,262,,
"Saduakassova, Dinara",137,125,262,,
"Tarnowski, Alfred",132,130,262,,
"Matlak, Marek",119,142,261,,
"Thorfinnsson, Bragi",126,135,261,,
"De la Paz Perdomo, Frank",143,118,261,,
"Leniart, Arkadiusz",135,126,261,,
"Grob, Henry",133,128,261,,
"Schreiner, Peter",126,135,261,,
"Nikitenko, Mihail",133,127,260,,
"Hromadka, Karel",129,131,260,,
"Khurtsidze, Nino",135,125,260,,
"Kobo, Ori",137,123,260,,
"Rychagov, Mikhail",133,127,260,,
"Pokojowczyk, Jerzy",120,140,260,,
"Levitt, Jonathan P.",129,131,260,,
"Kuzmin, Alexey",128,131,259,,
"Konstantinopolsky, Alexander",126,133,259,,
"Vogel, Roven",128,131,259,,
"Khanin, Semen",134,125,259,,
"Baumegger, Siegfried",125,134,259,,
"Kevlishvili, Robby",135,124,259,,
"Schneider, Ilja",136,123,259,,
"Treybal, Karel",129,130,259,,
"Mnatsakanian, Eduard A.",133,125,258,,
"Martin Gonzalez, Angel",126,132,258,,
"Perez Garcia, Rodney Oscar",127,131,258,,
"Lanc, Alois",133,125,258,,
"Andersen, Borge",130,128,258,,
"Munguntuul, Batkhuyag",116,141,257,,
"Winawer, Szymon",129,128,257,,
"Baumbach, Friedrich",122,135,257,,
"Yegiazarian, Arsen",132,125,257,,
"Moiseenko, Vadim",125,132,257,,
"Drimer, Dolfi",115,142,257,,
"Porath, Yosef",124,133,257,,
"Zaragatski, Ilja",129,128,257,,
"Peng, Zhaoqin",128,128,256,,
"Demidov, Mikhail",135,121,256,,
"Yankelevich, Lev",111,145,256,,
"Jasnikowski, Zbigniew",118,138,256,,
"Sosa, T. ARG",137,119,256,,
"Grabczewski, Romuald",135,121,256,,
"Kiriakov, Petr",123,132,255,,
"Martinez Alcantara, Jose Eduardo",134,121,255,,
"Gordon, Stephen J.",123,132,255,,
"Podzielny, Karl-Heinz Jr",123,132,255,,
"Neuman, Petr",123,132,255,,
"Fuller, Maxwell L.",127,128,255,,
"Kabanov, Nikolai",125,130,255,,
"Pavlov, Mircea-Sergiu-Aurelian",117,138,255,,
"Dai, Changren",132,122,254,,
"Iliesco, Juan",128,126,254,,
"Schebler, Gerhard",127,127,254,,
"Soltis, Andrew E.",125,129,254,,
"Sadorra, Julio Catalino",132,122,254,,
"Mozharov, Mikhail",140,114,254,,
"Abdumalik, Zhansaya",123,130,253,,
"Rombaldoni, Denis",132,121,253,,
"Yudin, Sergei",126,127,253,,
"Butnorius, Algimantas",128,125,253,,
"Adla, Diego",125,127,252,,
"Belikov, Vladimir",133,119,252,,
"Bukal, Vladimir",113,139,252,,
"Ginsburg, Gennadi",125,127,252,,
"Rantanen, Yrjo A.",140,112,252,,
"Potapov, Pavel",123,128,251,,
"Kolarov, Atanas S.",111,140,251,,
"Korley, Kassa",128,123,251,,
"Navarovszky, Laszlo",114,137,251,,
"Bunzmann, Dimitrij",119,132,251,,
"Milov, Leonid",122,129,251,,
"Ninov, Nikolai",119,132,251,,
"Lin, Chen",124,127,251,,
"Trois, Francisco RT",126,125,251,,
"Basman, Michael J.",125,125,250,,
"Florian, Tibor",130,120,250,,
"Balog, Imre",136,114,250,,
"Suleymenov, Alisher",124,126,250,,
"Belozerov, Andrei",125,125,250,,
"Asadli, Vugar",121,129,250,,
"Sulypa, Oleksandr",124,126,250,,
"Sokolsky, Alexey",117,133,250,,
"Romanovsky, Peter A.",124,126,250,,
"Nikolaevsky, Yuri V.",128,122,250,,
"Hasangatin, Ramil",114,136,250,,
"Yuferov, Sergey N.",121,128,249,,
"Vitolinsh, Alvis",124,125,249,,
"Pedersen, Eigil",121,128,249,,
"Evdokimov, Alexander A.",113,136,249,,
"Karasev, Vladimir I.",130,119,249,,
"Neukirch, Detlef",127,121,248,,
"Denker, Arnold S.",127,121,248,,
"Saric, Ibro",124,124,248,,
"Bosch, Jeroen",123,124,247,,
"Anka, Emil",123,124,247,,
"Fernandez, Daniel Howard",125,122,247,,
"Sanduleac, Vasile",114,132,246,,
"Rasmussen, Karsten",112,134,246,,
"Iskandarov, Misratdin",132,114,246,,
"Matveeva, Svetlana",127,119,246,,
"Gavrilescu, David",113,133,246,,
"Lyrberg, Patrik",117,129,246,,
"Rombaldoni, Axel",125,121,246,,
"Bacallao Alonso, Yusnel",120,126,246,,
"Simic, Radoslav",118,128,246,,
"Berg, Klaus",120,126,246,,
"Schiffers, Emanuel",120,125,245,,
"Nalbandian, Tigran",117,128,245,,
"Anikaev, Yuri N.",113,132,245,,
"Stern, Rene",125,120,245,,
"Berescu, Alin-Mile",125,120,245,,
"Vignesh, NR",131,114,245,,
"Castellanos Rodriguez, Renier",129,115,244,,
"Castro, Oscar Humberto",120,124,244,,
"Botterill, George S.",123,121,244,,
"Nguyen, Huynh Minh Huy",115,129,244,,
"Khamrakulov, Ibragim S.",123,121,244,,
"Bajarani, Ulvi",124,120,244,,
"Bojkov, Dejan",115,128,243,,
"Holzke, Frank",112,131,243,,
"Manor, Ilan",116,127,243,,
"Canal, Esteban",126,117,243,,
"Damaso, Rui",117,126,243,,
"Pranav, V.",128,115,243,,
"Yoo, Christopher Woojin",124,119,243,,
"Barrientos, Sergio E.",120,123,243,,
"Seeman, Tarvo",106,137,243,,
"Kaplan, Julio P.",122,120,242,,
"Petrushin, Alexander I.",118,124,242,,
"Horvath, Peter",109,133,242,,
"Mishra, Abhimanyu",127,115,242,,
"Rocha, Antonio",117,125,242,,
"McDonald, Neil",121,121,242,,
"Lodici, Lorenzo",122,120,242,,
"Pavlov, Sergey2",116,126,242,,
"Teclaf, Pawel",123,119,242,,
"Kazakov, Mikhail",116,125,241,,
"Kharitonov, Alexandr",115,126,241,,
"Henrichs, Thomas",123,118,241,,
"Cosma, Ioan",116,125,241,,
"Mellado Trivino, Juan",113,128,241,,
"Troeger, Paul",125,115,240,,
"Agzamov, Georgy",117,123,240,,
"Kelecevic, Nedeljko",106,134,240,,
"Beim, Valeri",114,126,240,,
"Santo-Roman, Marc",130,110,240,,
"Webb, Simon",115,124,239,,
"Ardiansyah, Haji",119,120,239,,
"Das, Arghyadip",115,124,239,,
"Calvo Minguez, Ricardo",119,120,239,,
"Banas, Jan",119,119,238,,
"Forcen Esteban, Daniel",120,118,238,,
"Nikolenko, Oleg",121,117,238,,
"De Greiff, Boris",114,124,238,,
"Belkhodja, Slim",130,108,238,,
"Doettling, Fabian",108,130,238,,
"Kalegin, Evgenij",108,129,237,,
"Narayanan, Srinath",115,122,237,,
"Pancevski, Filip",119,118,237,,
"Doroshkievich, Vladimir K.",111,126,237,,
"Zawadzka, Jolanta",121,116,237,,
"Barbosa, Oliver",117,120,237,,
"Dambacher, Martijn",127,109,236,,
"Ahues, Carl Oscar",123,113,236,,
"Iljin, Artem",125,110,235,,
"Galyas, Miklos",112,123,235,,
"Schoeneberg, Manfred",117,118,235,,
"Daneshvar, Bardiya",119,116,235,,
"Berzinsh, Roland",123,112,235,,
"Mosadeghpour, Masoud",107,127,234,,
"Utegaliyev, Azamat",115,119,234,,
"Videki, Sandor",109,125,234,,
"Van den Berg, Carel Benjamin",117,117,234,,
"Bogdanovich, Stanislav",116,118,234,,
"Pakleza, Zbigniew",121,112,233,,
"Yudovich, Mikhail M.",114,119,233,,
"Garcia Ilundain, David",121,112,233,,
"Zagorskis, Darius",108,125,233,,
"Alonso, Salvador",111,122,233,,
"Kestler, Hans-Guenther",109,124,233,,
"Maghalashvili, Davit",106,126,232,,
"Petenyi, Tamas",109,123,232,,
"Satyapragyan, Swayangsu",108,123,231,,
"Lombard, Andre",106,125,231,,
"Reefat, Bin-Sattar",117,114,231,,
"Collins, Sam E.",106,125,231,,
"Tempone, Marcelo",105,126,231,,
"Stopa, Jacek",115,116,231,,
"Nikolic, Zivoslav",101,130,231,,
"Radovici, Corvin",107,123,230,,
"Sisniega Campbell, Marcel",111,119,230,,
"Afanasiev, Nikita",125,105,230,,
"Swayams, Mishra",111,119,230,,
"Cardoso, Radolfo Tan",119,110,229,,
"Soos, Bela",106,123,229,,
"Grau, Roberto G.",122,107,229,,
"Pedersen, Steffen",121,108,229,,
"Lukov, Valentin",107,122,229,,
"Segal, Alexandru Sorin",109,119,228,,
"Reeh, Oliver",110,118,228,,
"Nigmatov, Ortik",117,111,228,,
"Frolov, Artur",117,111,228,,
"Ilivitzki, Georgi A.",112,116,228,,
"Andreev, Eduard",98,130,228,,
"Neubauer, Martin",116,112,228,,
"Schinzel, Wladyslaw",117,111,228,,
"Trent, Lawrence",109,119,228,,
"Brunner, Nicolas",124,104,228,,
"Kaminski, Marcin",126,102,228,,
"Fiorito, Fabian",112,116,228,,
"Kapnisis, Spyridon",110,117,227,,
"Huang, Qian",114,113,227,,
"Ravinsky, Grigory",117,110,227,,
"Haslinger, Stewart G.",113,113,226,,
"Smirnov, Artem",114,112,226,,
"Antonsen, Mikkel",118,108,226,,
"Kallio, Heikki",104,122,226,,
"Nilsson, Zandor",102,124,226,,
"Holm, Sejer",110,116,226,,
"Trapl, Jindrich",116,110,226,,
"Tarlev, Konstantin",105,121,226,,
"Peters, Jack",112,113,225,,
"Borgo, Giulio",116,109,225,,
"Budisavljevic, Luka",109,116,225,,
"Cortlever, Nico",120,105,225,,
"Bruno, Fabio",118,107,225,,
"Di Berardino, Diego Rafael",111,114,225,,
"Gundavaa, Bayarsaikhan",116,109,225,,
"Santiago, Yago De Moura",122,103,225,,
"Koziak, Vitali",122,103,225,,
"Cioara, Andrei-Nestor",112,113,225,,
"Dus Chotimirsky, Fedor",116,109,225,,
"Staunton, Howard",99,126,225,,
"Svane, Frederik",128,97,225,,
"Colovic, Aleksandar",100,124,224,,
"Gagare, Shardul",105,119,224,,
"Van Mil, Johannes AJ",108,116,224,,
"Gholami, Aryan",108,116,224,,
"Westerberg, Jonathan",106,118,224,,
"Fauland, Alexander",96,128,224,,
"Zaitsev, Alexander",110,113,223,,
"Peng, Xiaomin",117,106,223,,
"Yu, Shaoteng",104,119,223,,
"Matsenko, Sergei",108,115,223,,
"Albin, Adolf",113,110,223,,
"Enchev, Ivajlo",104,119,223,,
"Doric, Darko",100,123,223,,
"Ris, Robert",102,121,223,,
"Draskovic, Luka",115,107,222,,
"Gostisa, Leon",115,107,222,,
"Kovacs, Gabor2",93,129,222,,
"Ramesh, Ramachandran B.",101,121,222,,
"Thesing, Matthias",109,113,222,,
"Vrolijk, Liam",112,109,221,,
"Dimakiling, Oliver",101,120,221,,
"Howell, James C.",107,114,221,,
"Pierrot, Facundo",114,107,221,,
"Sandor, Bela",109,112,221,,
"Forster, Richard",87,134,221,,
"Lafuente, Pablo",108,113,221,,
"Belyakov, Bogdan",105,116,221,,
"Klimov, Sergey",112,109,221,,
"Gorovets, Andrey",106,115,221,,
"Chadaev, Nikolai",106,115,221,,
"Blau, Max",114,106,220,,
"Raznikov, Danny",103,117,220,,
"De Vreugt, Dennis",107,113,220,,
"Aagaard, Jacob",114,106,220,,
"Burke, John M.",111,109,220,,
"Dunkelblum, Arthur",111,109,220,,
"Ghosh, Diptayan",116,104,220,,
"Wiedenkeller, Michael",111,108,219,,
"Kosakowski, Jakub",116,103,219,,
"Nguyen, Van Huy",98,121,219,,
"Sevillano, Enrico",91,128,219,,
"Loeffler, Stefan",97,122,219,,
"Tania, Sachdev",105,113,218,,
"Scholl, Eddie C.",105,113,218,,
"Kriebel, Tadeas",122,96,218,,
"Faizrakhmanov, Ramil",111,107,218,,
"Zwardon, Vojtech",105,113,218,,
"Engels, Ludwig",106,112,218,,
"Simantsev, Mikhail",95,123,218,,
"Kupka, Slavoj",105,113,218,,
"Miljkovic, Miroslav D.",119,98,217,,
"Kristjansson, Stefan",96,121,217,,
"Johansson, Martin",114,103,217,,
"Sieciechowicz, Marcin",101,115,216,,
"Bailet, Pierre",98,118,216,,
"Khusnutdinov, Rustam",89,127,216,,
"Blees, Albert",107,109,216,,
"Bykhovsky, Anatoly A.",105,111,216,,
"Rakotomaharo, Fy Antenaina",104,112,216,,
"Pijpers, Arthur",106,110,216,,
"Menchik, Vera",106,110,216,,
"Salomon, Johan",112,104,216,,
"Von Bardeleben, Curt",107,109,216,,
"Mascarinas, Rico",98,118,216,,
"Tibensky, Robert",101,114,215,,
"Nikolic, Stanimir",101,114,215,,
"Przepiorka, Dawid",108,107,215,,
"Shtyrenkov, Veniamen",106,109,215,,
"Golubovic, Boris",100,115,215,,
"Barkhagen, Jonas",95,119,214,,
"Gharibyan, Mamikon",104,110,214,,
"Donchev, Dimitar I.",114,100,214,,
"Panjwani, Raja",109,105,214,,
"Kalezic, Blazo",103,111,214,,
"Stella, Andrea",110,104,214,,
"Myagmarsuren, Lhamsuren",102,112,214,,
"Znosko-Borovsky, Eugene A.",97,117,214,,
"Makogonov, Vladimir",105,109,214,,
"Popilski, Gil",98,116,214,,
"Cuijpers, Frans Andre",107,107,214,,
"Makhnev, Denis",107,106,213,,
"Ponizil, Cyril",106,107,213,,
"Pavlidis, Antonios",101,112,213,,
"Beikert, Guenther",111,102,213,,
"Kohlweyer, Bernd",106,107,213,,
"Mammadov, Zaur",110,103,213,,
"Sale, Srdjan",103,110,213,,
"Bitoon, Richard",108,104,212,,
"Gongora Reyes, Maikel Liber",101,111,212,,
"Pedersen, Nicolai Vesterbaek",101,111,212,,
"Ostojic, Nikola",97,115,212,,
"Faibisovich, Vadim Z.",106,106,212,,
"Levy, David NL",115,97,212,,
"Bui, Vinh",102,110,212,,
"Moreno Carnero, Javier",127,84,211,,
"Laketic, Gojko",103,108,211,,
"Whiteley, Andrew J.",107,104,211,,
"Heinicke, Herbert",100,111,211,,
"Van der Werf, Mark",95,116,211,,
"Pourramezanali, Amirreza",105,106,211,,
"Hunt, Adam C.",115,96,211,,
"Wohl, Aleksandar H.",107,103,210,,
"Smerdon, David C.",112,98,210,,
"Lobzhanidze, Davit",99,111,210,,
"Kuybokarov, Temur",108,102,210,,
"Flores Alvarez, Rodrigo",108,102,210,,
"Piazzini, Luis Roberto",105,105,210,,
"Pap, Gyula",104,105,209,,
"Varavin, Viktor",113,96,209,,
"Rejfir, Josef",106,103,209,,
"Summerscale, Aaron P.",91,118,209,,
"Holt, Conrad",105,104,209,,
"Jojua, Davit",99,110,209,,
"Peptan, Corina-Isabela",105,103,208,,
"Salinas Herrera, Pablo",95,113,208,,
"Kachiani-Gersinska, Ketino",103,105,208,,
"Ahlander, Bjoern Mikael",109,99,208,,
"Vavulin, Maxim",109,99,208,,
"Bellia, Fabrizio",98,110,208,,
"Lomasov, Semyon",106,102,208,,
"Seul, Georg",103,105,208,,
"Roselli Mailhe, Bernardo",97,110,207,,
"Book, Eero",98,109,207,,
"Minasian, Ara",105,102,207,,
"Mohrlok, Dieter",104,102,206,,
"Byrne, Donald",104,102,206,,
"Palkovi, Jozsef",109,97,206,,
"Sarkar, Justin",99,107,206,,
"Safin, Shukhrat",107,99,206,,
"Riemersma, Li",105,101,206,,
"Margvelashvili, Giorgi",95,111,206,,
"Cafferty, Bernard",99,107,206,,
"Zwaig, Arne",108,98,206,,
"Kiik, Kalle",99,106,205,,
"Sofrevski, Jovan",101,104,205,,
"Wang, Zili",106,99,205,,
"Horowitz, Israel Albert",102,103,205,,
"Raja, Harshit",93,112,205,,
"Sanz Alonso, Francisco J.",96,109,205,,
"Cheng, Bobby",108,97,205,,
"Krnic, Zdenko",96,109,205,,
"Sher, Miron N.",104,100,204,,
"Rodriguez, Ruben",101,103,204,,
"Ibrahimov, Rasul",93,111,204,,
"Brandenburg, Daan",105,99,204,,
"Triapishko, Alexandr",94,110,204,,
"Dudin, Gleb",104,100,204,,
"Fluvia Poyatos, Joan",100,103,203,,
"Li, Ruifeng",103,99,202,,
"Pietrusiak, Bogdan",100,102,202,,
"Fuster, Geza",91,110,201,,
"Totsky, Leonid",98,103,201,,
"Ortega, Rogelio",100,101,201,,
"Cruz, Raul C.",97,104,201,,
"Mohr, Stefan",111,90,201,,
"Matinian, Nikita",101,100,201,,
"Gross, Stefan",99,101,200,,
"Sankalp, Gupta",92,108,200,,
"Miron, Lucian-Costin",106,94,200,,
"Benidze, Davit",91,109,200,,
"Milner Barry, Philip",100,100,200,,
"Szymczak, Zbigniew",90,110,200,,
"Teterev, Vitaly",98,102,200,,
"Shaw, John K.",110,90,200,,
"Palermo, Vicente",98,102,200,,
"Froewis, Georg",96,103,199,,
"Karthikeyan, P.",105,94,199,,
"Katalymov, Boris",90,109,199,,
"Bortnyk, Olexandr",100,99,199,,
"Roussel-Roozmon, Thomas",98,101,199,,
"Seo, Jung Min",92,107,199,,
"Schallopp, Emil",106,92,198,,
"Gritsak, Orest",93,105,198,,
"Bulski, Krzysztof",94,104,198,,
"Ziatdinov, Raset",100,98,198,,
"Brenninkmeijer, Joris",100,98,198,,
"Bhend, Edwin",90,108,198,,
"Fedder, Steen",91,106,197,,
"Mikhalevski, Alexander",89,108,197,,
"Mollah Abdullah, Al Rakib",97,100,197,,
"Khmelniker, Ilya",86,111,197,,
"Foisor, Cristina-Adela",109,88,197,,
"Lauber, Arnd",104,93,197,,
"Berger, Johann Nepomuk",99,98,197,,
"Glud, Jakob Vang",103,94,197,,
"Ruban, Vadim",104,92,196,,
"MacKenzie, George H.",100,96,196,,
"Bojkovic, Natasa",105,91,196,,
"Gilg, Karl",100,96,196,,
"Nguyen, Duc Hoa",97,99,196,,
"Obukhov, Alexander",86,110,196,,
"Zhu, Jiner",94,102,196,,
"Sahidi, Samir",96,100,196,,
"Pilgaard, Kim",101,95,196,,
"Zarubitski, Viachaslau",108,88,196,,
"Maslak, Konstantin",100,95,195,,
"Breder, Dennis",98,97,195,,
"Izsak, Gyula",96,99,195,,
"Mititelu, Gheorghe",98,97,195,,
"Piskov, Yury",95,100,195,,
"Velten, Paul",81,114,195,,
"Vukovic, Zdravko",101,94,195,,
"Goldberg, Grigory A.",93,102,195,,
"Vaishali, Rameshbabu",97,97,194,,
"Molina, Roberto Junio Brito",81,113,194,,
"Finkel, Alexander",98,96,194,,
"Ungureanu, Emil",98,96,194,,
"Yu, Ruiyuan",91,103,194,,
"Sokolov, Vladimir",101,93,194,,
"Novak, Ivan",94,100,194,,
"Johansson, Linus",90,104,194,,
"Haygarth, Michael J.",104,90,194,,
"Olsson, Ake",98,95,193,,
"Richter, Michael",95,98,193,,
"Benkovic, Petar",89,104,193,,
"Day, Lawrence A.",93,100,193,,
"Petkov, Momchil",97,96,193,,
"Kushnir, Alla",104,89,193,,
"Landau, Salo",94,99,193,,
"Gromek, Jozef",99,94,193,,
"Liu, Qingnan",94,99,193,,
"Zhuravliov, Valerij",92,101,193,,
"Shoker, Samy",83,109,192,,
"Fluvia Poyatos, Jordi",90,102,192,,
"Vajda, Arpad",89,103,192,,
"Zanan, Evgeny",94,98,192,,
"Neikirkh, Oleg",101,91,192,,
"Kasparian, Genrikh M.",91,101,192,,
"Fernandez Romero, Ernesto",98,94,192,,
"Bilguun, Sumiya",93,99,192,,
"Mousavi, Seyed Khalil",99,93,192,,
"Novik, Maxim",91,101,192,,
"Littlewood, John E.",97,94,191,,
"Steiner, Endre",89,102,191,,
"Bogut, Zeljko",79,112,191,,
"Bellini, Fabio",91,100,191,,
"Debarnot, Roberto",97,94,191,,
"Dyachkov, Sergej",93,98,191,,
"Arribas Lopez, Angel",96,95,191,,
"Troff, Kayden W.",93,97,190,,
"Dueball, Juergen",105,85,190,,
"Ashley, Maurice",103,87,190,,
"Cohn, Erich",99,91,190,,
"Madaminov, Mukhiddin",99,91,190,,
"Estevez, Guillermo",97,92,189,,
"Nedeljkovic, Srecko",93,96,189,,
"Marinkovic, Ivan",84,105,189,,
"Birnboim, Nathan",95,94,189,,
"Poetsch, Hagen",98,91,189,,
"Zhao, Zong-Yuan",93,96,189,,
"Almasi, Istvan",82,107,189,,
"Rogoff, Kenneth S.",101,88,189,,
"Norwood, David R.",96,93,189,,
"Bulmaga, Irina",97,92,189,,
"Eliseev, Urii",94,95,189,,
"Iskov, Gert",91,98,189,,
"Moreno Ruiz, Javier",84,104,188,,
"Urazayev, Arystanbek",95,93,188,,
"Bazan, Osvaldo",95,93,188,,
"Schroeder, Jan-Christian",105,82,187,,
"Sipila, Vilka",97,90,187,,
"Arsovic, Goran",80,107,187,,
"Horvath, Gyula",91,96,187,,
"Partos, Charles",92,95,187,,
"Aitken, James",90,97,187,,
"Khamrakulov, Djurabek",83,104,187,,
"Ulko, Jaroslav",84,103,187,,
"Ye, Rongguang",94,93,187,,
"Moldovan, Daniel",82,105,187,,
"Parker, Jonathan F.",102,85,187,,
"Quesada Perez, Luis Ernesto",94,92,186,,
"Balinov, Ilia",98,88,186,,
"Loiseau, Quentin",89,97,186,,
"Golubov, Saveliy",91,95,186,,
"Kakageldyev, Amanmurad",98,88,186,,
"Liss, Eran",96,90,186,,
"Leenhouts, Koen",91,95,186,,
"Tu, Hoang Thong",84,102,186,,
"Ostermeyer, Peter",86,100,186,,
"Stankovic, Milos",83,103,186,,
"Dvoretzky, Mark",86,100,186,,
"Barendregt, Johan",88,98,186,,
"Rathnakaran, K.",86,100,186,,
"Bistric, Faruk",92,94,186,,
"Frias Apablaza, Victor",91,94,185,,
"Dobosz, Henryk",90,95,185,,
"Kreisl, Robert",90,95,185,,
"Bielczyk, Jacek",74,111,185,,
"Degerman, Lars",99,86,185,,
"Raja, Rithvik R.",92,93,185,,
"Ujtumen, Tudev",97,88,185,,
"Charbonneau, Pascal",95,90,185,,
"Polgar, Istvan",91,94,185,,
"Rakic, Tomislav",90,95,185,,
"Zysk, Robert",93,91,184,,
"Nevostrujev, Vladimir",87,97,184,,
"Maric, Rudolf",80,104,184,,
"Petrov, Vladimirs",93,91,184,,
"Kmoch, Hans",92,92,184,,
"Vladimirov, Boris T.",93,91,184,,
"Solovjov, Sergey I.",93,91,184,,
"Alvarez Pedraza, Aramis",86,97,183,,
"Kupper, Josef",88,95,183,,
"Douven, Rudy C.",88,95,183,,
"Aveskulov, Valeriy",103,80,183,,
"Moutousis, Konstantinos",97,86,183,,
"Boehnisch, Manfred",95,88,183,,
"Thorbergsson, Freysteinn",94,88,182,,
"Escobar Forero, Alder",98,84,182,,
"Roos, Daniel",94,88,182,,
"Jankovec, Ivan",92,90,182,,
"Walther, Edgar",94,88,182,,
"Zezulkin, Jurij",92,90,182,,
"Cabrera, Alexis",89,93,182,,
"Thiede, Lars",92,90,182,,
"Suechting, Hugo",90,92,182,,
"Chuprov, Dmitry",90,92,182,,
"Xu, Yuhua",85,97,182,,
"Loncar, Robert",81,101,182,,
"Kanovsky, David",96,85,181,,
"Shianovsky, Vladislav I.",94,87,181,,
"Reinaldo Castineira, Roi",93,88,181,,
"Konguvel, Ponnuswamy",85,96,181,,
"Odeev, Handszar",83,98,181,,
"Roganovic, Milos",91,90,181,,
"Handoko, Edhi",95,86,181,,
"Kekelidze, Mikheil",92,89,181,,
"Lupu, Mircea-Sergiu",94,86,180,,
"Petrov, Martin",89,91,180,,
"Usmanov, Vasily",91,89,180,,
"Cruz, Walter",88,92,180,,
"Fairhurst, William",88,92,180,,
"Notkin, Maksim",90,90,180,,
"Matviishen, Viktor",93,87,180,,
"Mateo, Ramon",87,93,180,,
"Kraai, Jesse",97,83,180,,
"Lorparizangeneh, Shahin",88,92,180,,
"Karner, Hillary",91,89,180,,
"Brinckmann, Alfred",89,90,179,,
"Pecorelli Garcia, Humberto",80,99,179,,
"Ader Hausman, Walter",93,86,179,,
"Wittmann, Walter",95,84,179,,
"Rezan, Sasa",88,91,179,,
"Pushkov, Nikolai",81,98,179,,
"Zagoriansky, Evgeny",88,91,179,,
"Staniszewski, Piotr",76,102,178,,
"Peng, Xiongjian",93,85,178,,
"Aloma Vidal, Robert",88,90,178,,
"Garcia Padron, Jose",93,85,178,,
"Urday, Henry",84,94,178,,
"Fish, Gennadij",84,94,178,,
"Khademalsharieh, Sarasadat",85,92,177,,
"Hoenlinger, Baldur",94,83,177,,
"Krzyzanowski, Marcin",87,90,177,,
"Das, Sayantan",81,96,177,,
"Grunberg, Mihai-Lucian",82,95,177,,
"Diamant, Andre",90,87,177,,
"Zuckerman, Bernard",81,96,177,,
"Rios Gomez, Cristhian Camilo",84,93,177,,
"Sikora-Lerch, Jan",91,85,176,,
"Rambaldi, Francesco",79,97,176,,
"Niephaus, Walter",89,87,176,,
"Skold, Kristian",89,87,176,,
"Hawkins, Jonathan",90,86,176,,
"Mrdja, Milan",83,93,176,,
"Lugovskoy, Maxim",90,86,176,,
"Anisimov, Pavel",80,96,176,,
"Anagnostopoulos, Dimitri",86,90,176,,
"Visser, Yge",85,91,176,,
"Nikitin, Aleksander S.",87,88,175,,
"Thorsteins, Karl",83,92,175,,
"Kanmazalp, Ogulcan",85,90,175,,
"Ambroz, Jan",75,100,175,,
"Zhukhovitsky, Samuel",92,83,175,,
"Stachowiak, Kamil",86,88,174,,
"Vahidov, Tair",86,88,174,,
"Rosselli del Turco, Stefano",84,90,174,,
"Milev, Zdravko",89,85,174,,
"Klaric, Zlatko",84,90,174,,
"Krishna, CRG",80,94,174,,
"Golubka, Petro",76,98,174,,
"Bagirov, Rufat",85,89,174,,
"Hungaski, Robert Andrew",93,81,174,,
"Vukovic, Sava",86,88,174,,
"Delorme, Axel",81,93,174,,
"Masic, Ljubomir",80,93,173,,
"Vranesic, Zvonko",89,84,173,,
"Varga, Peter",76,97,173,,
"Behrensen, Jorge",85,88,173,,
"Zajic, Milan",85,88,173,,
"Villegas, Benito H.",88,85,173,,
"Kozomara, Vlado",89,84,173,,
"Byvshev, Vasily",87,86,173,,
"Shabanov, Yuri",83,90,173,,
"Brzozka, Stefan",83,90,173,,
"Chen, Qi b",82,91,173,,
"Marzolo, Cyril",86,86,172,,
"Lehner, Oliver",85,87,172,,
"Averkin, Orest N.",87,85,172,,
"Przewoznik, Jan",77,95,172,,
"Kim, Alexey",78,94,172,,
"Mammadzada, Gunay",83,89,172,,
"Kolbak, Jens",89,82,171,,
"Yang, Darwin",88,83,171,,
"Leventic, Ivan",80,91,171,,
"Drenchev, Petar",76,95,171,,
"Ojanen, Kaarle S.",83,88,171,,
"Smirnov, Anton",94,77,171,,
"Poldauf, Dirk",87,84,171,,
"Ochsner, Bjorn Moller",83,87,170,,
"Moiseev, Oleg L.",80,90,170,,
"Santasiere, Anthony E.",84,86,170,,
"Olland, Adolf George",84,86,170,,
"Visier Segovia, Fernando",84,86,170,,
"Zifroni, Dov",75,95,170,,
"Assaubayeva, Bibisara",86,84,170,,
"Sanguinetti, Renato",78,92,170,,
"Zamikhovsky, Abram",81,89,170,,
"Shaked, Tal",88,81,169,,
"Englisch, Berthold",86,83,169,,
"Karolyi, Tibor Jr",75,94,169,,
"Tihonov, Jurij",79,90,169,,
"Dastan, Muhammed Batuhan",84,85,169,,
"Lev, Ronen",89,80,169,,
"Berndt, Stephan",84,85,169,,
"Souleidis, Georgios",90,79,169,,
"Kuporosov, Viktor",79,90,169,,
"Panarin, Mikhail",91,78,169,,
"Szilagyi, Peter",88,81,169,,
"Siegel, Georg",84,85,169,,
"Gokerkan, Cem Kaan",81,87,168,,
"Eisinger, Max Jr",85,83,168,,
"Zinchenko, Yaroslav",81,87,168,,
"Bharath, Subramaniyam H.",81,87,168,,
"Alexandria, Nana",82,86,168,,
"Ochoa de Echaguen, Fco Javier",66,102,168,,
"Fenoglio, Virgilio",82,86,168,,
"Sherzer, Alexander",80,88,168,,
"Sahl, Bjarke Barth",76,92,168,,
"Naranja, Renato",83,84,167,,
"Vouldis, Angelos",82,85,167,,
"Tyomkin, Dimitri",82,85,167,,
"Shvidler, Eliahu",85,82,167,,
"Hambleton, Aman",65,102,167,,
"Shytaj, Luca",81,86,167,,
"Sapi, Laszlo",72,95,167,,
"Taubenhaus, Jean",84,83,167,,
"Mons, Leon",81,86,167,,
"Franco Alonso, Alejandro",82,85,167,,
"Hoen, Ragnar",90,77,167,,
"Prameshuber, Aleksander",85,82,167,,
"Filipovic, Branko",85,82,167,,
"Maiorov, Oleg",72,95,167,,
"Moe, Mogens",78,89,167,,
"Yilmazyerli, Mert",93,74,167,,
"Drygalov, Andrey",79,88,167,,
"Tzermiadianos, Andreas",87,79,166,,
"Tin, Jingyao",91,75,166,,
"Salmensuu, Olli",77,89,166,,
"Kaasen, Tor Fredrik",82,84,166,,
"Moroz, Alexander",85,81,166,,
"Vassallo Barroche, Mauricio",81,85,166,,
"Sefc, Jan",79,87,166,,
"Kaiszauri, Konstanty",84,82,166,,
"Kononenko, Dmitry1",88,78,166,,
"Szelag, Marcin",86,80,166,,
"D'Amore, Carlo",73,93,166,,
"Zakharov, Alexander V.",79,86,165,,
"Neckar, Lubomir",82,83,165,,
"Sanchez, Luis Augusto",87,78,165,,
"Vajda, Albert",71,94,165,,
"Wieczorek, Oskar",81,84,165,,
"Keller, Dieter",85,80,165,,
"Vehi Bach, Victor Manuel",78,87,165,,
"Zichichi, Alvise",78,87,165,,
"Koch, Berthold",87,78,165,,
"Radovanovic, Nikola",78,87,165,,
"Littlewood, Paul E.",71,94,165,,
"Diesen, Mark C.",86,79,165,,
"Alvarez del Monte, Jose Luis",82,83,165,,
"Sharavdorj, Dashzegve",76,89,165,,
"Makarczyk, Kazimierz",82,83,165,,
"Hovhannisyan, Mher",75,89,164,,
"Djurasevic, Bozidar",80,84,164,,
"Zelbel, Patrick",83,81,164,,
"Jerez Perez, Alfonso",77,87,164,,
"Plenca, Jadranko",85,79,164,,
"Petkevich, Jusefs",73,91,164,,
"Stoica, Valentin",76,88,164,,
"Kayumov, Dmitry D.",88,76,164,,
"Greet, Andrew N.",75,88,163,,
"Subelj, Jan",85,78,163,,
"Lane, Gary W.",89,74,163,,
"Gazik, Igor",82,81,163,,
"Neumann, Gustav",83,80,163,,
"Havasi, Kornel",89,74,163,,
"Van den Bosch, Johannes",86,77,163,,
"Saldano Dayer, Horacio",78,85,163,,
"Borriss, Martin",88,75,163,,
"Herraiz Hidalgo, Herminio",81,82,163,,
"Potapov, Alexander",78,85,163,,
"Koberl, Ferenc",84,79,163,,
"Hindle, Owen M.",78,84,162,,
"Lahno, Katerina",79,83,162,,
"Ek, Hans",79,83,162,,
"Cramling, Dan",77,85,162,,
"Schenk, Andreas",76,86,162,,
"Drozdowski, Kacper",77,85,162,,
"Smederevac, Petar",82,80,162,,
"Hoelzl, Franz",73,89,162,,
"Swiderski, Rudolf",79,83,162,,
"Ivanov, Jordan",77,85,162,,
"Murariu, Andrei",79,83,162,,
"Zeller, Frank",74,88,162,,
"Melia, Salome",85,77,162,,
"Real De Azua, Ernesto",66,96,162,,
"Ziska, Helgi Dam",75,87,162,,
"Quinones Carrillo, Oscar",79,82,161,,
"Ringoir, Tanguy",70,91,161,,
"Rizouk, Aimen",72,89,161,,
"Abbasov, Farid",85,76,161,,
"Ozsvath, Andras",82,79,161,,
"Seidman, Herbert",82,79,161,,
"Glavina, Pablo",83,78,161,,
"Gurel, Ediz",81,80,161,,
"Estrada Degrandi, Walter",75,86,161,,
"Ferreira, Jorge Viterbo",82,79,161,,
"Johannsson, Ingi R.",79,82,161,,
"Lasker, Edward",78,82,160,,
"Molner, Mackenzie",79,81,160,,
"Stefansson, Vignir Vatnar",83,77,160,,
"Prraneeth, Vuppala",77,83,160,,
"Jacimovic, Dragoljub",64,96,160,,
"Espinosa Veloz, Ermes",80,80,160,,
"Tipary, Lajos",79,81,160,,
"Acosta, Pablo Ismael",78,82,160,,
"Kalesis, Nikolaos",75,85,160,,
"Winter, William",80,80,160,,
"Shinkevich, Vitaly",72,88,160,,
"Steinberg, Nitzan",81,79,160,,
"Gawlikowski, Stanislaw",82,78,160,,
"Casas, Fernando",82,78,160,,
"Gonzalez Acosta, Bernal",70,89,159,,
"Klaman, Konstantin M.",76,83,159,,
"Krassowizkij, Jaroslaw",84,75,159,,
"Kelires, Andreas",74,85,159,,
"Polovodin, Igor A.",83,76,159,,
"Bhat, Vinay S.",84,75,159,,
"Skatchkov, Pavel",68,91,159,,
"Guerra Mendez, Jose Angel",77,82,159,,
"Davtyan, Artur",83,75,158,,
"Blehm, Pawel",81,77,158,,
"Kristinsson, Jon",63,95,158,,
"Mirumian, Vigen",88,70,158,,
"Nitin, S.",77,81,158,,
"Van der Stricht, Geert",83,75,158,,
"Starck, Bodo",83,75,158,,
"El Debs, Felipe de Cresce",76,82,158,,
"Bartholomew, John",68,90,158,,
"Ledger, Andrew J.",76,82,158,,
"Abdisalimov, Abdimalik",77,81,158,,
"Bryakin, Mikhail",67,91,158,,
"Smith, Bryan G.",76,82,158,,
"Himanshu, Sharma",71,86,157,,
"Ulvestad, Olaf",78,79,157,,
"Shaikh, Mohammad Nubairshah",80,77,157,,
"Wood, Baruch Harold",75,82,157,,
"Makropoulos, Georgios",74,83,157,,
"Gorelov, Sergey G.",72,85,157,,
"Ilyin Zhenevsky, Alexander",81,76,157,,
"Pekarek, Ales",84,73,157,,
"Sergienko, Sergey",74,82,156,,
"Quintiliano, Renato R.",81,75,156,,
"Chajes, Oscar",82,74,156,,
"Gurevich, Vladimir",74,82,156,,
"Dembo, Yelena",80,76,156,,
"Liang, Jinrong",72,84,156,,
"Llaneza Vega, Marcos",80,76,156,,
"Agmanov, Zhandos",73,83,156,,
"Hirneise, Tobias",81,75,156,,
"Henley, Ron W.",72,84,156,,
"Rethy, Pal",82,74,156,,
"Nun, Jiri",80,76,156,,
"Wang, Yiye",78,78,156,,
"Espinosa Flores, Rafael",71,85,156,,
"Giustolisi, Alberto Mario",72,84,156,,
"Pranav, Anand",85,71,156,,
"Gines Esteo, Pedro Antonio",84,72,156,,
"Annageldyev, Orazly",77,79,156,,
"Gorshtein, Ido",72,84,156,,
"Corte, Cesar J.",78,77,155,,
"Haldorsen, Benjamin",76,79,155,,
"Kuderinov, Kirill",77,78,155,,
"Jarmula, Lukasz",85,70,155,,
"Renner, Christoph",82,73,155,,
"Heidenfeld, Wolfgang",75,79,154,,
"Nenezic, Marko",82,72,154,,
"Ekenberg, Bengt",75,79,154,,
"Janjghava, Lasha",80,74,154,,
"Alavkin, Arseny",76,78,154,,
"Tot, Bora",78,76,154,,
"Managadze, Nikoloz",75,79,154,,
"Novopashin, Arkady",77,77,154,,
"Schneider, Dmitry",83,71,154,,
"Bekker-Jensen, Simon",70,84,154,,
"Maksimovic, Branimir",74,80,154,,
"Gonzalez Perez, Arian",83,71,154,,
"Drygalov, Sergey",74,80,154,,
"Porreca, Giorgio",78,76,154,,
"Kaufman, Larry C.",81,73,154,,
"Goh, Wei Ming Kevin",76,78,154,,
"Arjun, Kalyan",77,77,154,,
"Tang, Andrew",76,77,153,,
"Hauge, Lars Oskar",76,77,153,,
"Balinas, Rosendo C.",81,72,153,,
"Porper, Edward",72,81,153,,
"Mangini, Jose",78,75,153,,
"Marini, Luis",75,78,153,,
"Nestorovic, Dejan",76,77,153,,
"Barcenilla, Rogelio",65,87,152,,
"Lampert, Jonas",73,79,152,,
"Teran Alvarez, Ismael",75,77,152,,
"Volodin, Aleksandr",77,75,152,,
"Khasin, Alexander",64,88,152,,
"Von Minckwitz, Johannes",71,81,152,,
"Walbrodt, Carl",80,72,152,,
"Grabarczyk, Bogdan",82,70,152,,
"Ginzburg, Maximiliano",70,82,152,,
"Gunnarsson, Jon Viktor",69,83,152,,
"Gerzhoy, Leonid",67,85,152,,
"Houska, Jovanka",77,75,152,,
"Eslon, Jaan",77,74,151,,
"Mozetic, Dejan",77,74,151,,
"Espinosa Aranda, Angel",75,76,151,,
"Shocron, Ruben",78,73,151,,
"Mitrabha, Guha",78,73,151,,
"Gutierrez Herrera, Jose Antonio",74,77,151,,
"Sjodahl, Pontus",71,80,151,,
"Holm, Kristian Stuvik",77,74,151,,
"Lazavik, Denis",78,72,150,,
"Puiggros, Guillermo",72,78,150,,
"Schitco, Ivan",68,82,150,,
"Piasetski, Leon",76,74,150,,
"Stany, GA",74,76,150,,
"Galperin, Platon",82,68,150,,
"Ostrovskiy, Aleksandr A.",79,71,150,,
"Drozd, Ryszard",70,80,150,,
"Tan, Justin2",83,67,150,,
"Kopylov, Michael",65,85,150,,
"Rosenthal, Samuel",75,75,150,,
"Ghizdavu, Dumitru",76,74,150,,
"Kupchik, Abraham",79,70,149,,
"Jirka, Jiri",80,69,149,,
"Stempin, Pawel",66,83,149,,
"Grebnev, Aleksey",84,65,149,,
"Hall, Jesper",69,80,149,,
"Caspi, Israel",77,72,149,,
"Preotu, Razvan",78,71,149,,
"Kogan, Boris M.",74,75,149,,
"Gurevich, Ilya",68,81,149,,
"Sherwin, James T.",70,79,149,,
"Bryzgalin, Kirill",65,84,149,,
"Von Gottschall, Hermann",76,73,149,,
"Bouaziz, Slim",71,78,149,,
"Weiss, Miksa",72,77,149,,
"Gorbatov, Alexej",69,80,149,,
"Peterson, Andrejs",68,81,149,,
"Wadsworth, Matthew J.",75,74,149,,
"Seret, Jean-Luc",76,72,148,,
"Kosyrev, Vladimir",66,82,148,,
"Martin del Campo C., Roberto",69,79,148,,
"Erdogmus, Yagiz Kaan",76,72,148,,
"Simutowe, Amon",74,74,148,,
"Palliser, Richard JD",62,86,148,,
"Baldauf, Marco",71,77,148,,
"Bellaiche, Anthony",65,83,148,,
"Williams, A. Howard",71,77,148,,
"Bagheri, Amir",69,79,148,,
"Thejkumar, MS",79,69,148,,
"Checa, Nicolas D.",79,69,148,,
"Vasilev, Milen",69,78,147,,
"Bohatirchuk, Fedor",71,76,147,,
"Zwirs, Nico",74,73,147,,
"Petran, Peter",75,72,147,,
"Grigorov, Grigor",66,81,147,,
"Arzumanian, Georgy",62,85,147,,
"Rodriguez Guerrero, Enrique",70,77,147,,
"Atabayev, Maksat",73,74,147,,
"Prokopchuk, Evgeny",73,74,147,,
"Noe, Christopher",76,71,147,,
"Fedorovsky, Michael",76,71,147,,
"Michell, Reginald",69,78,147,,
"Vedmediuc, Serghei",74,72,146,,
"Koblencs, Alexander",65,81,146,,
"Shubin, Kirill",77,69,146,,
"Dinstuhl, Volkmar",69,77,146,,
"Mahjoob Zardast, Morteza",70,76,146,,
"Gomez Garrido, Camilo Ernesto",80,66,146,,
"Loman, Rudolf",72,74,146,,
"Marsalek, Josef",73,72,145,,
"Borge, Nikolaj",69,76,145,,
"Petronic, Jovan",78,67,145,,
"Bachtiar, Arovah",67,78,145,,
"Hong, Andrew Z.",73,72,145,,
"Csonka, Balazs",74,71,145,,
"Pranesh, M.",74,71,145,,
"Hendriks, Willy",69,76,145,,
"Nayhebaver, Martin",71,74,145,,
"El Gindy, Essam",76,68,144,,
"Nigalidze, Gaioz",64,80,144,,
"Pithart, Frantisek",73,71,144,,
"Negulescu, Adrian",67,77,144,,
"Czakon, Jakub",75,69,144,,
"Pedzich, Dominik",68,76,144,,
"Jakovljevic, Vlado",77,67,144,,
"Kacharava, Nikolozi",64,80,144,,
"Tarasov, Vitaly G.",69,75,144,,
"Breyer, Gyula",72,72,144,,
"Vojinovic, Goran",66,78,144,,
"Saptarshi, Roy",72,72,144,,
"Dubinin, Peter",75,69,144,,
"Zufic, Miroslav",83,60,143,,
"Haria, Ravi",63,80,143,,
"Priyadharshan, Kannappan",72,71,143,,
"Ladva, Ottomar",77,66,143,,
"Perez Rodriguez, Luis Manuel",69,74,143,,
"Franklin, Michael J.",72,71,143,,
"Gaehwiler, Gabriel",72,71,143,,
"Guidarelli, Laurent",63,79,142,,
"Schaefer, Markus",63,79,142,,
"Maciejewski, Andrzej",73,69,142,,
"Ding, Yixin",75,67,142,,
"Rojas Keim, Luis",70,72,142,,
"Perunovic, Miodrag",74,68,142,,
"Palo, Davor",71,71,142,,
"Garcia, Gilberto",70,72,142,,
"Martz, William",71,71,142,,
"Gladyszev, Oleg",68,74,142,,
"Kourkoulos-Arditis, Stamatis",76,66,142,,
"Jeremic, Veljko",65,77,142,,
"Huerga Leache, Mikel",69,72,141,,
"Kosashvili, Yona",68,73,141,,
"Aloni, Itzchak",67,74,141,,
"Garriga Cazorla, Pere",72,69,141,,
"Helmers, Knut J.",71,70,141,,
"Eliet, Nicolas",66,75,141,,
"Sideifzade, Fikret I.",60,81,141,,
"Skrobek, Ryszard",67,74,141,,
"Zumsande, Martin",67,74,141,,
"Royal, Shreyas",68,73,141,,
"Ezat, Mohamed",68,73,141,,
"Krapivin, Alexander",77,63,140,,
"Veresov, Gavriil N.",73,67,140,,
"Cohn, Wilhelm",68,72,140,,
"Scheeren, Peter",69,71,140,,
"Waitzkin, Joshua",72,68,140,,
"Niklasson, Christer",74,66,140,,
"Villamayor, Buenaventura",65,75,140,,
"Vidmar, Milan Jr",66,74,140,,
"Janetschek, Karl",66,74,140,,
"Klavins, Janis",73,67,140,,
"Hase, Juan Carlos",74,66,140,,
"Florian, Jaromir",75,65,140,,
"Sarakauskas, Gediminas",62,78,140,,
"Marangunic, Srdjan",57,83,140,,
"Sarapu, Ortvin",67,73,140,,
"Lebredo Zaragoitia, Gerardo",69,71,140,,
"Kishnev, Sergey",74,65,139,,
"Vazquez, Guillermo",69,70,139,,
"Liptay, Laszlo",63,76,139,,
"Wang, Justin",71,68,139,,
"Perlis, Julius",73,66,139,,
"Bernstein, Sidney",72,67,139,,
"Deze, Anton",63,76,139,,
"Kinzel, Anton",67,72,139,,
"Baenziger, Fabian",59,80,139,,
"Adams, Weaver",70,69,139,,
"Azaladze, Shota",74,65,139,,
"Bukal, Vladimir Jr",62,77,139,,
"Petersen, Finn",63,75,138,,
"Van Baarle, C. John",65,73,138,,
"Notkevich, Benjamin Arvola",67,71,138,,
"Incutto, Carlos",71,67,138,,
"Zilberstein, Valery I.",69,69,138,,
"Fernandez Cardoso, Alexey",65,73,138,,
"Wang, Rui",67,71,138,,
"Minaya, Juan M.",65,73,138,,
"Cruz, Filemon",65,73,138,,
"Henderson de La Fuente, Lance",68,70,138,,
"Nakar, Eylon",69,69,138,,
"Burnett, Ronald",67,71,138,,
"Bauza, Lorenzo",71,67,138,,
"Pavlovic, Milos M.",70,68,138,,
"Dragomarezkij, Evgeni",68,70,138,,
"Tahbaz, Arash",67,71,138,,
"Carls, Carl Johan Margot",69,69,138,,
"Nechaeva, Marina",68,70,138,,
"Matikozian, Andranik",68,70,138,,
"Valdes Romero, Leonardo",72,65,137,,
"Carlstedt, Jonathan",66,71,137,,
"Vlassov, Nikolai",59,78,137,,
"Tristan, Leonardo",65,72,137,,
"Bialas, Wolfram",69,68,137,,
"Filep, Tibor",70,67,137,,
"Formanek, Edward W.",72,65,137,,
"Buksa, Nataliya",66,71,137,,
"Hansen, Torbjorn Ringdal",66,71,137,,
"Liang, Chong",65,72,137,,
"Knox, Victor W.",78,58,136,,
"Fazekas, Stefan",72,64,136,,
"Shtembuliak, Evgeny",62,74,136,,
"Sadikhov, Ulvi",76,60,136,,
"Arenas, David",73,63,136,,
"Pleci, Isaias",66,70,136,,
"Ost-Hansen, Jacob",64,72,136,,
"Sturt, Raven M.",72,64,136,,
"Kreiman, Boris",67,69,136,,
"From, Sigfred",68,68,136,,
"Dourerassou, Jonathan",65,71,136,,
"Castaldi, Vincenzo",68,68,136,,
"Mista, Ladislav",64,72,136,,
"Prokes, Ladislav",68,68,136,,
"Ioannidis, Ev",64,71,135,,
"Gasztonyi, Endre",67,68,135,,
"Simonian, Hrair",66,69,135,,
"Delmar, Eugene",64,71,135,,
"Baljon, Christofoor",69,66,135,,
"Buljovcic, Ivan",68,67,135,,
"Jauregui, Carlos",70,65,135,,
"Brond, Victor",71,64,135,,
"Hnydiuk, Aleksander",63,72,135,,
"Zhou, Yang-Fan",81,54,135,,
"Tsvetkov, Alexandar K.",62,73,135,,
"Liublinsky, Victor",66,69,135,,
"Priasmoro, Novendra",77,58,135,,
"Kostic, Vladimir G.",65,70,135,,
"Lindberg, Bengt",73,62,135,,
"Wilder, Michael J.",58,77,135,,
"Gadimbayli, Abdulla",60,74,134,,
"Cori Tello, Deysi Estella",70,64,134,,
"Lee, Peter N.",67,67,134,,
"Gonzalez De La Torre, Santiago",66,68,134,,
"Martin, Andrew D.",54,80,134,,
"Gagarin, Vasilij",69,65,134,,
"Frey Beckman, Kenneth",61,73,134,,
"Supatashvili, Khvicha",67,67,134,,
"Lubbe, Nikolas",74,60,134,,
"Sloth, Jorn",63,71,134,,
"Liu, Guanchu",63,70,133,,
"Ghasi, Ameet K.",59,74,133,,
"Brodowski, Piotr",66,67,133,,
"Mikhaletz, Lubomir",71,62,133,,
"Talla, Vladimir",68,65,133,,
"Schwarz, Adolf",64,69,133,,
"Weinstein, Norman",65,68,133,,
"Ivanov, Victor L.",71,62,133,,
"Roy Chowdhury, Saptarshi",64,69,133,,
"Baghdasaryan, Vahe",62,71,133,,
"Lorenzo De La Riva, Lazaro",66,67,133,,
"Van Wijgerden, Cornelis",62,70,132,,
"Brueggemann, Joachim",65,67,132,,
"Tylor, Theodore",64,68,132,,
"Khruschiov, Alexey",63,69,132,,
"Govedarica, Radovan",72,60,132,,
"Commons, Kim S.",65,67,132,,
"Novikov, Maxim",66,66,132,,
"Barbosa, Evandro Amorim",69,63,132,,
"Kots, Yuri I.",65,67,132,,
"Barden, Leonhard William",68,64,132,,
"Wegerle, Joerg",56,76,132,,
"Manca, Federico",65,66,131,,
"Shahinyan, David",58,73,131,,
"Kaspi, Alexander",60,71,131,,
"Nolte, Rolando",68,63,131,,
"Vistaneckis, Isakas",60,71,131,,
"Munkhgal, Gombosuren",61,70,131,,
"Van Geet, Dirk Daniel",63,68,131,,
"John, Walter",63,68,131,,
"Kuzmicz, Krystian",63,68,131,,
"Savanovic, Aleksandar",56,75,131,,
"De Jong, Jan-Willem",65,66,131,,
"Asztalos, Lajos",63,68,131,,
"Solleveld, Maarten",63,68,131,,
"Badelka, Olga",64,67,131,,
"Sanchez, Joseph",72,59,131,,
"Schaufelberger, Heinz",65,66,131,,
"Vetoshko, Volodymyr",63,68,131,,
"Kelly, Brian",63,67,130,,
"Schmidt, Paul Felix",67,63,130,,
"Javakhadze, Zurab",69,61,130,,
"Sorokin, Aleksey",66,64,130,,
"Donchenko, Anatoly",63,67,130,,
"Addison, Wiliam G.",63,67,130,,
"Huss, Andreas",64,66,130,,
"Boey, Josef",56,74,130,,
"Besser, Hans",60,70,130,,
"Nogerbek, Kazybek",63,67,130,,
"Anurag, Mhamal",60,69,129,,
"Garcia, Horacio",60,69,129,,
"Cyfka, Karina",63,66,129,,
"Pein, Malcolm",67,62,129,,
"Laurent-Paoli, Pierre",62,67,129,,
"Harrwitz, Daniel",64,65,129,,
"Bertholdt, Dieter",67,62,129,,
"Pulvett Marin, Daniel Eduardo",68,61,129,,
"Matnadze, Ana",65,64,129,,
"Malinovsky, Karel",72,57,129,,
"Rogovski, Vladimir",67,62,129,,
"Admiraal, Miguoel",62,67,129,,
"Gusev, Yuri S.",61,68,129,,
"Crouch, Colin S.",68,61,129,,
"Borkowski, Franciszek",68,61,129,,
"Bradvarevic, Aleksandar",55,73,128,,
"Vernay, Clovis",70,58,128,,
"Hevia Alejano, Carlos Antonio",61,67,128,,
"Noritsyn, Nikolay",64,64,128,,
"Barbot, Pierre1",64,64,128,,
"Samunenkov, Ihor",66,62,128,,
"Nosenko, Alexander",60,68,128,,
"Kolosowski, Mateusz",59,69,128,,
"Lemos, Damian",59,68,127,,
"Skalkotas, Nikolaos",65,62,127,,
"Ljubicic, Filip",68,59,127,,
"Vandenbussche, Thibaut",70,57,127,,
"Bator, Robert",53,74,127,,
"Zivanic, Marko",58,69,127,,
"Ippolito, Dean",58,69,127,,
"Shahade, Gregory",64,63,127,,
"Dann, Matthias",68,59,127,,
"D'Costa, Lorin AR",68,59,127,,
"Gaprindashvili, Valeriane",58,69,127,,
"Solomon, Stephen J.",60,67,127,,
"Zhidkov, Valery S.",67,60,127,,
"Volkmann, Friedrich Karl",59,68,127,,
"Sergeant, Edward G.",59,68,127,,
"Zurakhov, Vladlen Y.",65,62,127,,
"Villanueva, Mario",66,61,127,,
"Lutsko, Igor",70,57,127,,
"Lee, Francis Joseph",67,60,127,,
"Tomovic, Vasilje",63,64,127,,
"Ragozin, Evgeni",60,67,127,,
"Kociscak, Jiri",65,62,127,,
"McKay, Roderick M.",62,64,126,,
"Peng, Li Min",64,62,126,,
"Miranda Mesa, Elier",55,71,126,,
"Saric, Sinisa",59,67,126,,
"Loskutov, Oleg",66,60,126,,
"Pascua, Haridas",63,63,126,,
"Martin, Pedro",66,60,126,,
"Jacobsen, Bo",65,61,126,,
"Van der Weide, Piet",61,65,126,,
"Cossin, Sebastien",63,63,126,,
"Skytte, Rasmus",54,72,126,,
"Guliev, Logman",55,71,126,,
"Oliva Castaneda, Kevel",65,60,125,,
"Grefe, John A.",64,61,125,,
"Jedynak, Radoslaw",63,62,125,,
"Otero Acosta, Diasmany",64,61,125,,
"Jongsma, Alexander",67,58,125,,
"Vaisman, Volodia",65,60,125,,
"Napier, William",60,65,125,,
"Petrosian, Davit G.",61,64,125,,
"Wibe, Terje Paul",56,69,125,,
"Zhalmakhanov, Ramazan",61,64,125,,
"Hunt, Harriet V.",60,65,125,,
"Bernard, Ryszard",62,63,125,,
"Thomas, Andrew RB",70,55,125,,
"Supi, Luis Paulo",62,63,125,,
"Fawzy, Adham",67,58,125,,
"Sokolovsky, Yahli",62,63,125,,
"Escalante Ramirez, Brian",60,64,124,,
"Lange, Wilfried",55,69,124,,
"Kuipers, Stefan",54,70,124,,
"Semkov, Semko",67,57,124,,
"Olsen, Filip Boe",56,68,124,,
"Adamski, Andrzej",64,60,124,,
"Seitz, Jakob Adolf",70,54,124,,
"Markland, Peter Richard",59,65,124,,
"Pytlakowski, Andrzej",66,58,124,,
"Ma, Zhonghan",67,57,124,,
"Zilber, Israel",67,57,124,,
"Zhelnin, Vladimir V.",62,61,123,,
"Harandi, Khosro",58,65,123,,
"Filip, Lucian-Ioan",53,70,123,,
"Sochacki, Christophe",76,47,123,,
"Noa, Josef",62,61,123,,
"Vijayalakshmi, Subbaraman",60,63,123,,
"Von Balla, Zoltan",61,62,123,,
"Miljanic, Boro",61,62,123,,
"Iermito, Sebastian",63,60,123,,
"Balakrishnan, Praveen",65,58,123,,
"Vratonjic, Slobo",52,71,123,,
"Brestian, Egon",55,68,123,,
"Zlotnik, Boris A.",57,66,123,,
"Ruzele, Darius",65,58,123,,
"Reilly, Brian Patrick",62,61,123,,
"Van Haastert, Edwin",69,54,123,,
"Shaw, Terrey Ian",60,63,123,,
"Loewenthal, Johann",64,59,123,,
"Gschnitzer, Oswald",63,59,122,,
"Haring, Filip",62,60,122,,
"Blom, Kaj",61,61,122,,
"Hawelko, Marek",65,57,122,,
"Gual Pascual, Antonio",60,62,122,,
"Tutisani, Noe",60,62,122,,
"Zugic, Igor",60,62,122,,
"Franz, Joachim",65,57,122,,
"Hesse, Peter",62,60,122,,
"Nadyrhanov, Sergey",56,66,122,,
"Horwitz, Bernhard",62,60,122,,
"Atabayev, Yusup",62,60,122,,
"Chernikov, Oleg L.",56,66,122,,
"Olivera, Alfredo",59,62,121,,
"Weiss, Christian",64,57,121,,
"Terrieux, Kevin",54,67,121,,
"Sipos, Istvan",54,67,121,,
"Licznerski, Lukasz",58,63,121,,
"Thorsteinsson, Bjorn",63,58,121,,
"Kolvig, Bent",64,57,121,,
"Nowak, Erwin",61,60,121,,
"Yepez Obando, Olavo",62,59,121,,
"Jaffe, Charles",60,61,121,,
"Temirbayev, Serikbay",58,63,121,,
"Hermann, Manfred",63,58,121,,
"Zierk, Steven C.",59,62,121,,
"Kosanovic, Goran A.",54,67,121,,
"Mihaljcisin, Mihajlo",59,61,120,,
"Koltanowski, George",62,58,120,,
"Bleiman, Yaacov",56,64,120,,
"Erenberg, Ariel",65,55,120,,
"Paulsen, Wilfried",59,61,120,,
"Gholami Orimi, Mahdi",61,59,120,,
"Guo, Qi",62,58,120,,
"Frydman, Paulino",62,58,120,,
"Nguyen, Piotr",61,59,120,,
"Pantzar, Milton",63,57,120,,
"Nozdrachev, Vladislav",58,61,119,,
"Dietze, Wolfgang",56,63,119,,
"Can, Isik",53,66,119,,
"Sultan Khan, Mir",57,62,119,,
"Uusi, Gunnar",61,58,119,,
"Rosenlund, Thorbjorn",54,65,119,,
"Palau, Luis",60,59,119,,
"Zhao, Yuanhe",58,61,119,,
"Renman, Nils-Gustaf",60,59,119,,
"Zinser, Sylvain",58,61,119,,
"Klundt, Klaus",63,56,119,,
"Levitina, Irina S.",56,63,119,,
"Butkiewicz, Lukasz",70,49,119,,
"Arnold, Marc T.",52,67,119,,
"Khegay, Dmitriy",57,61,118,,
"Torma, Robert",58,60,118,,
"Dake, Arthur William",60,58,118,,
"Zatulovskaya, Tatiana",54,64,118,,
"Dutreeuw, Marc",58,60,118,,
"Kozionov, Kirill",57,61,118,,
"Littlewood, Norman",57,61,118,,
"Szabolcsi, Janos",48,70,118,,
"Esposito, Alfredo",62,56,118,,
"Domnitz, Zadok",61,57,118,,
"German, Eugenio",55,63,118,,
"Forgacs, Leo",60,58,118,,
"Rovner, Dmitry",51,66,117,,
"Ly, Moulthun",55,62,117,,
"Chibukhchian, Artur",54,63,117,,
"Verlinsky, Boris M.",59,58,117,,
"Alexandrova, Olga",61,56,117,,
"Srihari, LR",58,59,117,,
"Lepelletier, Benoit",51,66,117,,
"Almagro Llamas, Pablo",59,58,117,,
"Gomez Baillo, Jorge H.",55,62,117,,
"Fang, Yuxiang",57,60,117,,
"Belezky, Alexander",54,63,117,,
"Corden, Martyn J.",61,56,117,,
"Baird, David Graham",58,58,116,,
"Sitnikov, Anton",55,61,116,,
"Poulsen, Christian",61,55,116,,
"Saydaliev, Saidakbar",52,64,116,,
"Podgorny, Jiri",56,60,116,,
"Givon, Asaf",62,54,116,,
"Zude, Arno",60,56,116,,
"Cekro, Ekrem",55,61,116,,
"Suarez Gomez, Julio",62,54,116,,
"Kayumov, Sergey",49,67,116,,
"Zirngibl, Albert",54,62,116,,
"Atabayev, Saparmyrat",57,58,115,,
"Boskovic, Drasko",70,45,115,,
"Coudari, Camille",52,63,115,,
"Gadia, Olicio",60,55,115,,
"Kozlovskaya, Valentina",58,57,115,,
"Liang, Jason",59,56,115,,
"Budo, Alexander S.",59,56,115,,
"Panelo, Marcelo",64,51,115,,
"Krylov, Mikhail RUS",57,58,115,,
"Borik, Otto",60,55,115,,
"Arabidze, Meri",65,50,115,,
"Von Scheve, Theodor",61,54,115,,
"Litinskaya, Marta I.",62,52,114,,
"Haub, Thorsten Michael",57,57,114,,
"Vlachos, Anatole",50,64,114,,
"Stulik, Vlastimil",59,55,114,,
"Franzoni, Giancarlo",46,68,114,,
"Klimkowski, Jan",55,59,114,,
"Prasanna, Raghuram Rao",62,52,114,,
"Taulbut, Shaun M.",56,58,114,,
"Prasca Sosa, Rafael Felipe",59,55,114,,
"Moser, Eva",59,55,114,,
"Pert, Richard G.",58,56,114,,
"Paveto, Kevin",57,56,113,,
"Nezad, Husein Aziz",56,57,113,,
"Gross, David",55,58,113,,
"Belov, Igor",56,57,113,,
"Orlov, Andrey",59,54,113,,
"Docx, Stefan",55,58,113,,
"Henneberke, Franciscus",53,60,113,,
"Andersen, Erik",51,62,113,,
"Krakops, Maris",54,59,113,,
"Clemens, Christian",61,52,113,,
"Liljedahl, Lennart",55,58,113,,
"Cuasnicu, Oscar",50,63,113,,
"Danailov, Silvio",50,63,113,,
"Parvanyan, Ashot",54,59,113,,
"Hennigan, Michael T.",54,59,113,,
"Baron Rodriguez, Jesus",52,61,113,,
"Daulyte-Cornette, Deimante",58,55,113,,
"Primavera, Giuseppe",57,55,112,,
"Mukhin, Mikhail",60,52,112,,
"Monticelli, Mario",58,54,112,,
"Borngaesser, Rene",58,54,112,,
"Smikovski, Ivan",53,59,112,,
"Dolezal, Cristian",54,58,112,,
"Varnusz, Egon",54,58,112,,
"Beradze, Irakli",53,58,111,,
"Orbaan, Constant",56,55,111,,
"Magomedov, Magaram",53,58,111,,
"Tishin, Petr",55,56,111,,
"Buckels, Valentin",60,51,111,,
"Woodward, Andy",55,56,111,,
"Kopylov, Nikolai G.",56,55,111,,
"Maljutin, Evgeni",53,57,110,,
"Ankit, R. Rajpara",50,60,110,,
"Reshetnikov, Alexey",52,58,110,,
"Navrotescu, Catalin",45,65,110,,
"Illingworth, Max",55,55,110,,
"Krizsany, Laszlo",49,61,110,,
"Kalugin, Sergey G.",48,62,110,,
"Kubicek, Antonin",52,58,110,,
"Hagen, Andreas Skytte",50,60,110,,
"Vila Gazquez, Xavier",59,51,110,,
"Akvist, Hakan",56,54,110,,
"Garifullina, Leya",49,61,110,,
"Priehoda, Vitezslav",55,55,110,,
"Andrianov, Nikolai",48,62,110,,
"Todorov, Todor",55,55,110,,
"Mueller, Klaus-Uwe",55,55,110,,
"Szpar, Milosz",58,52,110,,
"Kramer, George Mortimer",51,59,110,,
"Sofronie, Iulian",51,59,110,,
"Parkhov, Yair",57,53,110,,
"Bely, Miklos",52,57,109,,
"Sivokho, Sergey",57,52,109,,
"Andruet, Gilles",58,51,109,,
"Batsuren, Dambasuren",53,56,109,,
"Collutiis, Duilio",52,57,109,,
"Zaltsman, Vitaly F.",52,57,109,,
"Radovanovic, Mihajlo",61,48,109,,
"Toth, Ervin",48,61,109,,
"Dworzynski, Roman",53,56,109,,
"Stryjecki, Marek",51,58,109,,
"Mogranzini, Roberto",57,52,109,,
"Gusain, Himal",54,55,109,,
"Lewi, Jerzy",55,54,109,,
"Georgescu, Tiberiu-Marian",58,51,109,,
"Bastrikov, Georgy",51,57,108,,
"Rebizzo, Cayetano",51,57,108,,
"Vasiesiu, Dan",59,49,108,,
"Drabke, Lorenz Maximilian",53,55,108,,
"Wagner, Heinrich",49,59,108,,
"Angantysson, Haukur",59,49,108,,
"Nikitin, Andrey",47,61,108,,
"Schwartzman, Gabriel",54,54,108,,
"Shmuter, Leonid",48,60,108,,
"Egin, Vladimir",50,58,108,,
"Cosulich, Roberto",56,52,108,,
"Genocchio, Daniele",53,55,108,,
"Yeletsky, Ivan",55,53,108,,
"Macskasy, Elod",52,56,108,,
"Morphy, Paul",52,56,108,,
"Kilgus, Georg",55,53,108,,
"Fridh, Anton",50,58,108,,
"Lin, Weiguo",51,57,108,,
"Szabados, Eugenio",59,48,107,,
"Bocharov, Ivan",50,57,107,,
"Kezin, Roman",50,57,107,,
"Willow, Jonah B.",58,49,107,,
"Georgiadis, Ioannis",51,56,107,,
"Gorodetzky, David",43,64,107,,
"Rauzer, Vsevolod",57,50,107,,
"Saraci, Nderim",53,54,107,,
"Redolfi, Argentino Rodolfo",54,53,107,,
"Hilby, Craig",58,49,107,,
"Lie, Espen",52,55,107,,
"Luczak, Andrzej",57,50,107,,
"Postler, Reinhard",49,58,107,,
"Hajtun, Jozsef",50,57,107,,
"Xu, Zhihang",54,53,107,,
"Khusenkhojaev, Muhammad",57,50,107,,
"Esserman, Marc",51,55,106,,
"Rocha, Sergio",54,52,106,,
"Vesely, Jiri",50,56,106,,
"Schoppen, Casper",53,53,106,,
"Tilicheev, Viacheslav",51,55,106,,
"Nowak, Ignacy",47,59,106,,
"Ahmadzada, Ahmad",54,52,106,,
"Rohacek, Ivan",54,52,106,,
"Parr, Frank",49,57,106,,
"Zilberman, Nathan R.",55,51,106,,
"Tissir, Mohamed",50,56,106,,
"Muehlberg, Siegfried",51,55,106,,
"Costachi, Mihnea",44,62,106,,
"Sukandar, Irine Kharisma",49,57,106,,
"Jelen, Igor",52,54,106,,
"Urzica, Aurel",52,54,106,,
"Wu, Wenjin",57,48,105,,
"Korchmar, Vasiliy",52,53,105,,
"Berezjuk, Sergej",47,58,105,,
"Kostiuchenko, Alexander I.",51,54,105,,
"Kharchenko, Boris",49,56,105,,
"Koelle, Tobias",49,56,105,,
"Seel, Christian",56,49,105,,
"Khodos, German L.",46,59,105,,
"Vizantiadis, Lazaros",43,62,105,,
"Skomorokhin, Roman",58,47,105,,
"Obodchuk, Andrei",48,57,105,,
"Szabo, Zsolt Jozsef",48,57,105,,
"Buslaev, Aleksander",53,52,105,,
"Kaczur, Florian",48,57,105,,
"Andric, Dragoslav",53,52,105,,
"Chekhov, Sergei",48,57,105,,
"Riumin, Nikolai",52,53,105,,
"Senff, Martin",46,59,105,,
"Lapshun, Yury",49,56,105,,
"Ljungquist, Lennart",56,49,105,,
"Savitskiy, Sergey",56,49,105,,
"Irzhanov, Ruslan",49,56,105,,
"Macovei, Andrei",57,48,105,,
"Henao, Raul Fernando",53,52,105,,
"Prakash, GB",50,55,105,,
"Tomescu, Vlad",51,54,105,,
"Barski, Radoslaw",56,48,104,,
"Nikolov, Sasho",59,45,104,,
"Menezes, Christoph",50,54,104,,
"Wang, Puchen",50,54,104,,
"Heinig, Wolfram",48,56,104,,
"Kamishov, Mikhail P.",56,48,104,,
"Zoltek, Tadeusz",48,56,104,,
"Meszaros, Tamas",53,51,104,,
"Levin, Naum L.",48,56,104,,
"Wessman, Richard",48,56,104,,
"Aghamaliyev, Cemil",44,60,104,,
"Rahul, Srivatshav P.",49,55,104,,
"Liascovich, Lucas",51,53,104,,
"Runic, Zoran",55,49,104,,
"Gonzales, Jayson",43,61,104,,
"Juarez, Carlos Eleodoro",52,52,104,,
"Pogrebissky, Iosif",52,52,104,,
"Brameyer, Hermann",49,55,104,,
"Judd, Max",52,52,104,,
"Bersamina, Paulo",49,55,104,,
"Eley, Brian",53,50,103,,
"Budnikov, Alexandar",53,50,103,,
"Schachinger, Mario",50,53,103,,
"Selezniev, Alexey",51,52,103,,
"Srbis, Jurica",47,56,103,,
"Xiang, Zeyu",53,50,103,,
"Dolezal, Jiri",52,51,103,,
"Petriashvili, Nikoloz",51,52,103,,
"Cruz, Jonathan",52,51,103,,
"Glass, Eduard",50,53,103,,
"Metger, Johannes",49,54,103,,
"Ladron De Guevara Pinto, Paolo",50,53,103,,
"Fernandez Gonzalez, Juan Carlos",47,56,103,,
"Donaldson-Akhmilovskaya, Elena",47,56,103,,
"Gutenev, Alexander",43,60,103,,
"Freiman, Sergey Nikolaevich",57,46,103,,
"Abrahams, Gerald",50,53,103,,
"Lamard, Guillaume",52,51,103,,
"Cvorovic, Drazen",48,54,102,,
"Siddharth, Jagadeesh",51,51,102,,
"Burger, Karl",57,45,102,,
"Mokshanov, Alexey",55,47,102,,
"Hermansson, Emil",55,47,102,,
"Solomunovic, Igor",42,60,102,,
"Bany, Jerzy",58,44,102,,
"Ratkovic, Miloje",54,48,102,,
"Gilevych, Artem",48,54,102,,
"Gonzalez, Renier",46,56,102,,
"Johner, Hans",58,44,102,,
"Kolisch, Ignatz",52,50,102,,
"Grinberg, Eyal",55,47,102,,
"Moskalenko, Alexander",48,54,102,,
"Apsenieks, Fricis",52,50,102,,
"Braga, Cicero Nogueira",42,60,102,,
"Nechepurenko, Roman V.",46,56,102,,
"Klein, David",45,56,101,,
"Sousa, Andre Ventura",56,45,101,,
"Paschall, William M.",50,51,101,,
"Sterk, Karoly",52,49,101,,
"Mateuta, Gabriel",45,56,101,,
"Abel, Dennes",51,50,101,,
"De Boer, Gert-Jan",46,55,101,,
"Sygulski, Artur",50,51,101,,
"Ivanov, Oleg V.",50,51,101,,
"Zagorovsky, Vladimir",48,53,101,,
"Balanel, Ion",53,48,101,,
"Lekic, Dusan",49,52,101,,
"Nitish, Belurkar",44,57,101,,
"Poutiainen, Pertti",54,47,101,,
"Rodriguez Gonzales, Jesus",49,52,101,,
"Norby, Peter H.",46,55,101,,
"Lipschuetz, Samuel",52,49,101,,
"Engel, Luis",52,49,101,,
"Pomes Marcet, Juan",51,50,101,,
"Reicher, Emanoil-George",55,46,101,,
"Radev, Nikolai",51,50,101,,
"Sapis, Witalis",38,62,100,,
"Sedina, Elena",49,51,100,,
"Kondratiev, Pavel E.",52,48,100,,
"Biolek, Richard Jr",55,45,100,,
"Neugebauer, Martin",51,49,100,,
"Ravi, Lanka",49,51,100,,
"Luch, Michal",45,55,100,,
"Wu, Shaobin",50,50,100,,
"Jakab, Attila",47,53,100,,
"Stoliar, Efim Samoilovich",51,49,100,,
"De Castro, Edgar",43,57,100,,
"Gallego Alcaraz, Andres Felipe",49,51,100,,
"Vavrak, Peter",52,48,100,,
"Alexakis, Dimitris",47,53,100,,
"Li, Wenliang",47,53,100,,
"De Freitas, Marcio Elisio",51,49,100,,
"Vorontsov, Pavlo",50,50,100,,
"Salimova, Nurgyul",54,45,99,,
"Feher, Gyula",52,47,99,,
"Gyorkos, Lajos",42,57,99,,
"Zurek, Milan",49,50,99,,
"Cela, Altin",53,46,99,,
"Garcia, Luis E.",51,48,99,,
"Bachin, Vitaly",50,49,99,,
"Podlesnik, Bogdan",40,59,99,,
"Franzen, Jozef",50,49,99,,
"Kozhuharov, Spas",43,56,99,,
"Brodsky, David",54,45,99,,
"Pajkovic, Vladimir",38,61,99,,
"Verduga Zavala, Denis",44,55,99,,
"Ohanyan, Emin",59,40,99,,
"Horberg, Bengt-Eric",59,40,99,,
"Koustav, Chatterjee",52,47,99,,
"Heissler, Jakob",50,49,99,,
"Boudy, Julio",45,54,99,,
"Reefschlaeger, Helmut",47,52,99,,
"Cabarkapa, Novak",52,47,99,,
"Osmak, Yuliia",52,47,99,,
"Panchenko, Alexandar G.",48,50,98,,
"Schoen, Wolfram",53,45,98,,
"Sviridov, Valery",46,52,98,,
"Ducarmon, Quinten",50,48,98,,
"Hounie Fleurquin, Carlos",50,48,98,,
"Sion Castro, Marcelino",44,54,98,,
"Stojanovski, Dejan",42,56,98,,
"Seidler, Aldo Emilio",50,48,98,,
"Feletar, Darko",36,62,98,,
"Koutsin, Sergey",41,57,98,,
"Ryskin, Alexander",53,45,98,,
"Orlov, Vassily",42,56,98,,
"Janzelj, Tim",43,55,98,,
"Nielsen, Axel Jorgen",52,46,98,,
"Bercys, Salvijus",43,54,97,,
"El Taher, Fouad",44,53,97,,
"Krivoborodov, Egor",46,51,97,,
"Pedersen, Erik",48,49,97,,
"Airapetian, Gor",48,49,97,,
"Dittmann, Sieghart",52,45,97,,
"Le, Tuan Minh",52,45,97,,
"Gomez Fontal, Felix Manuel",45,52,97,,
"Niemela, Ilmari Aarne",50,47,97,,
"Grigorov, Jordan N.",44,53,97,,
"Ovod, Evgenija",48,49,97,,
"Takacs, Sandor",49,48,97,,
"Bryant, John Daniel",46,51,97,,
"Boyer, Mahel",50,47,97,,
"Boidman, Yuri",47,50,97,,
"McCambridge, Vincent",43,54,97,,
"Travadon, Loic",48,49,97,,
"Bratanov, Zsivko",41,56,97,,
"Dieks, Roy G.",46,50,96,,
"Ardelean, George-Catalin",47,49,96,,
"Ksieski, Zbigniew",41,55,96,,
"Aaron, Manuel",48,48,96,,
"Feuerstack, Aljoscha",48,48,96,,
"Krivonosov, Oleg",39,57,96,,
"Maeder, Karl-Heinz",46,50,96,,
"Maharramzade, Javad",50,46,96,,
"Peretz, Malkiel",41,55,96,,
"Abdelnabbi, Imed",45,51,96,,
"Franic, Milan",47,49,96,,
"Speijer, Abraham",49,47,96,,
"Keinanen, Toivo",49,47,96,,
"Pinkas, Karol",50,46,96,,
"Vukcevich, Milan R.",48,48,96,,
"Dobrowolski, Piotr",46,50,96,,
"Vesselovsky, Serguei",51,45,96,,
"Lizak, Peter",49,47,96,,
"Goglidze, Viktor A.",50,46,96,,
"Schiffer, Karl-Josef",48,48,96,,
"Reshef, Omer",49,47,96,,
"Bernal Moro, Luis Javier",43,53,96,,
"Rade, Miroslav",48,48,96,,
"Loetscher, Roland",47,49,96,,
"Bagi, Mate",49,46,95,,
"Hergott, Deen",40,55,95,,
"Etruk, Rein T.",54,41,95,,
"Holaszek, Hans",46,49,95,,
"Schekachikhin, Maksim",45,50,95,,
"Belkadi, Ridha",49,46,95,,
"Tan, Lian Ann",51,44,95,,
"Kovacevic, Slobodan",42,53,95,,
"Ruiz Castillo, Joshua Daniel",49,46,95,,
"Antoli Royo, Joaquin Miguel",44,51,95,,
"Baidetskyi, Valentin",45,50,95,,
"Micheli, Carlo",47,48,95,,
"Boersma, Paul",47,48,95,,
"Perenyi, Bela",50,45,95,,
"Cibulka, Vladimir",41,54,95,,
"Boutteville, Cesar",44,51,95,,
"Roedl, Ludwig",50,45,95,,
"Korzubov, Peter",48,47,95,,
"Djukic, Zeljko",47,48,95,,
"Koch, Thomas",49,46,95,,
"Hvenekilde, Jorgen",46,49,95,,
"Shainswit, George",45,50,95,,
"Gavrilakis, Nikolaos",43,52,95,,
"Matuszewski, Michal",50,45,95,,
"Barnaure, Vlad-Victor",45,50,95,,
"Pokorny, Amos",51,43,94,,
"Schneider, Attila",36,58,94,,
"Fernandez, Daniel (USA)",44,50,94,,
"Aguero Jimenez, Luis Lazaro",54,40,94,,
"Gascon Del Nogal, Jose Rafael",50,44,94,,
"Cacho Reigadas, Sergio",48,46,94,,
"Cappello, Renato",48,46,94,,
"Sakalauskas, Vaidas",43,51,94,,
"Eggleston, David J.",47,47,94,,
"Schroll, Gerhard",43,51,94,,
"Rojicek, Vojtech",46,48,94,,
"Tica, Sven",50,44,94,,
"Bonner, Gerald",43,51,94,,
"Poliak, Abram",46,48,94,,
"Wahlbom, Magnus",50,44,94,,
"Barus, Cerdas",40,54,94,,
"Gaifullin, Artur",44,50,94,,
"Te Kolste, Jan Willem",45,48,93,,
"Roizman, Abram Y.",50,43,93,,
"Meister, Peter",42,51,93,,
"Aitbayev, Aslan",49,44,93,,
"Zheliandinov, Viktor",53,40,93,,
"Ardeleanu, Alin",47,46,93,,
"Rytov, Boris",46,47,93,,
"Marszalek, Rafal",45,48,93,,
"De Rooi, Paul",42,51,93,,
"Llado Lumbera, Jaime",52,41,93,,
"Kozlov, Vladimir N.",45,48,93,,
"Holmsten, Aleksei",44,49,93,,
"Matera, Salvatore Joseph",49,44,93,,
"Bonch-Osmolovsky, Mikhail",51,42,93,,
"Van der Vliet, Fred",47,46,93,,
"Feigin, Movsa",47,46,93,,
"Matjushin, Gennady",37,56,93,,
"Obregon, Andres Carlos",49,44,93,,
"Brown, Michael William",40,53,93,,
"Sarno, Spartaco",45,48,93,,
"Florean, Andrei-Costel",39,54,93,,
"Shalimov, Valery",45,48,93,,
"Dodero, Emilio",45,48,93,,
"Tomazini, Zan",50,42,92,,
"Jamieson, Robert M.",48,44,92,,
"Maksimovic, Bojan",40,52,92,,
"Sjoberg, Mats",45,47,92,,
"Mulyar, Michael A.",49,43,92,,
"Fahrni, Hans",42,50,92,,
"Collas, Didier",38,54,92,,
"Dvalishvili, Pavel S.",47,45,92,,
"Skorchenko, Dmitriy",43,49,92,,
"Koellner, Ruben Gideon",47,45,92,,
"Stearman, Josiah",46,46,92,,
"Tiller, Bjorn",45,47,92,,
"Fiebig, Thomas",49,43,92,,
"Rath, Ulrik",52,40,92,,
"Huang, Renjie",44,48,92,,
"Kraut, Rainer",44,48,92,,
"Braun, Gottfried",51,41,92,,
"De Riviere, Jules",47,45,92,,
"Sorensen, Jan",47,44,91,,
"Prasad, Dhulipalla Bala Chandra",45,46,91,,
"Mikkelsen, Nikolaj",40,51,91,,
"Geirnaert, Steven",42,49,91,,
"Jelen, Iztok",39,52,91,,
"Lazarev, Efrim M.",43,48,91,,
"Kotkov, Yuri M.",44,47,91,,
"Lazarevic, Milunka",39,52,91,,
"Hakki, Imad",44,47,91,,
"Dunis, Aurelien",47,44,91,,
"Sokolovs, Andrei",46,45,91,,
"Konovalov, Nikolay",47,44,91,,
"Diaz Camallonga, Carles",45,46,91,,
"Garcia Vera, Romeo",46,45,91,,
"Har-Zvi, Ronen",35,56,91,,
"Juswanto, Denny",40,51,91,,
"Helling, Karl",45,46,91,,
"Maus, Soenke",45,46,91,,
"Menvielle Laccourreye, Augusto",42,49,91,,
"Ruan, Lufei",45,46,91,,
"Machulsky, Anatoly D.",43,48,91,,
"Perkins, Alan H.",45,46,91,,
"Charousek, Rudolf Rezso",46,44,90,,
"Siaperas, Triantafyllos",46,44,90,,
"Sharafiev, Azat",48,42,90,,
"Salvador, Roland",50,40,90,,
"Schlindwein, Rolf",41,49,90,,
"Van Seters, Frits",47,43,90,,
"Neef, Maximilian",48,42,90,,
"Omelja, Artem",48,42,90,,
"Balshan, Amikam",40,50,90,,
"Buerger, Victor",47,43,90,,
"Sumar, Julio",45,45,90,,
"Pinkus, Albert",42,48,90,,
"Vaitonis, Povilas",50,40,90,,
"Williams, Elijah",46,44,90,,
"Recuero Guerra, David",48,42,90,,
"David, Pavel",43,47,90,,
"Suer, Nevzat",42,48,90,,
"Toufighi, Homayoon",41,49,90,,
"Rosito, Jorge",45,45,90,,
"Akash, Ganesan",50,40,90,,
"Charnushevich, Aliaksei",43,47,90,,
"Eperjesi, Laszlo",40,50,90,,
"Zablotsky, Sergei",37,53,90,,
"Szabo, Iuliu",46,44,90,,
"Fred, Aatos",47,43,90,,
"Pirrot, Dieter",42,47,89,,
"Sampouw, Jacobus S.",45,44,89,,
"Asmundsson, Ingvar",40,49,89,,
"Salai, Ladislav",38,51,89,,
"Velickovic, Sasa",44,45,89,,
"Stoppel, Franz",47,42,89,,
"Fritz, Alexander",47,42,89,,
"Babazada, Khazar",42,47,89,,
"Antunac, Goran",44,45,89,,
"Gunawan, Ronny",46,43,89,,
"Lipka, Juraj",39,50,89,,
"Dokutchaev, Alexander F.",34,55,89,,
"Ibarra Chami, Luis Fernando",43,46,89,,
"Tolstikh, Nikolay",42,47,89,,
"Ansat, Aldiyar",48,41,89,,
"Tirard, Hugo",47,42,89,,
"Fabian, J.",40,49,89,,
"Lempert, Igor",48,41,89,,
"Seemann, Jakub",43,45,88,,
"Hoeksema, Hendrik Pieter",41,47,88,,
"Silva Sanchez, Carlos",45,43,88,,
"Nestler, Vincenzo",43,45,88,,
"Poulsen, Allan",48,40,88,,
"Stanciu, Traian",50,38,88,,
"Salas Romo, Julio",41,47,88,,
"Roberson, Peter T.",49,39,88,,
"Donoso Velasco, Pedro H.",40,48,88,,
"Andonov, Bogomil",42,46,88,,
"Zavgorodniy, Sergiy",42,46,88,,
"Hujbert, Florian",45,43,88,,
"Sellos, Didier",45,43,88,,
"Koenig, Imre",44,44,88,,
"Persitz, Raaphi",46,42,88,,
"Danielian, Oganes",43,45,88,,
"Sherbakov, Vitaly",42,46,88,,
"Limp, Eduardo Thelio",45,43,88,,
"Ayats Llobera, Gerard",43,45,88,,
"Vooremaa, Andres",36,51,87,,
"Chernobay, Artem",46,41,87,,
"Low, Zhen Yu Cyrus",46,41,87,,
"Dzhakaev, Dzhakay",47,40,87,,
"Girel, Joseph",43,44,87,,
"Nguyen, Anh Khoi",44,43,87,,
"Nadanian, Ashot",45,42,87,,
"Castillo Larenas, Mariano",47,40,87,,
"Lendwai, Reinhard",34,53,87,,
"Skalicka, Karel",45,42,87,,
"Sek, Konstantin",46,41,87,,
"Qi, Jingxuan",44,43,87,,
"Piesina, Gintautas",41,46,87,,
"Obregon Rivero, Juan Carlos",40,47,87,,
"Von Popiel, Ignatz",44,43,87,,
"Gan-Erdene, Sugar",38,49,87,,
"Brondum, Eric",45,42,87,,
"Brooks, Michael A.",43,44,87,,
"Raghunandan, Kaumandur Srihari",40,47,87,,
"Palmason, Gudmundur",44,43,87,,
"Nithander, Victor",45,42,87,,
"Lipnitsky, Isaac",42,45,87,,
"Kruszynski, Wlodzimierz",44,43,87,,
"Akshayraj, Kore",45,41,86,,
"Hansson, Dan",44,42,86,,
"Clarke, Brandon GI",46,40,86,,
"Ernst, Wilhelm",41,45,86,,
"Fridstein, German Samuilovich",44,42,86,,
"Manasterski, Lutoslaw",42,44,86,,
"Stalmach, Richard",51,35,86,,
"Balogh, Janos",48,38,86,,
"Belavenets, Sergey",46,40,86,,
"Germek, Milan",44,42,86,,
"Stoeckl, Ernst",46,40,86,,
"Cordovil, Joao",43,43,86,,
"Muthaiah, AL",45,41,86,,
"Saravanan, Venkatachalam",46,40,86,,
"Uddenfeldt, Dan",41,45,86,,
"Jezek, Jaroslav",42,44,86,,
"Hlousek, Zdenek",46,40,86,,
"Oganian, Miran",41,45,86,,
"Prucha, Karel",43,43,86,,
"Wagman, Stuart",36,50,86,,
"Sikula, Vaszilij",36,50,86,,
"Milu, Romeo-Sorin",38,48,86,,
"McDonnell, Alexander",41,45,86,,
"Samant, Aditya S.",47,39,86,,
"Paramos Dominguez, Roberto",36,50,86,,
"Caro, Horatio",42,44,86,,
"Arapovic, Vitomir",35,51,86,,
"Messing, Hrvoje",44,42,86,,
"Mazzoni, Guy",50,35,85,,
"Fatalibekova, Elena",45,40,85,,
"Scafarelli, Francesco",49,36,85,,
"Baird, John Washington",42,43,85,,
"Bozic, Aleksandar",40,45,85,,
"Zlochevskij, Alexander",38,47,85,,
"Szuhanek, Ranko",33,52,85,,
"Rodrigue-Lemieux, Shawn",38,47,85,,
"Kunsztowicz, Uwe",39,46,85,,
"List, Paul",43,42,85,,
"Zawadzki, Stanislaw",46,39,85,,
"Nievergelt, Erwin",38,47,85,,
"Bronstein, Or",42,43,85,,
"Bjerring, Kai",49,36,85,,
"Doncea, Vladimir",44,41,85,,
"Salemgareev, Tagir",39,46,85,,
"Chebotarev, Oleg",43,42,85,,
"Nurkic, Sahbaz",37,48,85,,
"Orlov, Georgi",35,50,85,,
"Shmit, Anatoly",43,42,85,,
"Novotelnov, Nikolai",42,43,85,,
"Spacek, Petr",43,42,85,,
"Pajeken, Jakob Leon",39,46,85,,
"Ignatiev, Felix N.",37,47,84,,
"Mihajlovskij, Sergei",33,51,84,,
"Rabinovich, Abram",41,43,84,,
"Ikeda, Junta",44,40,84,,
"Murphy, Conor E.",42,42,84,,
"Dominguez, Cristobal",39,45,84,,
"Avila Pavas, Santiago",47,37,84,,
"Stoyanov, Tsvetan",41,43,84,,
"Drozdov, Igor",46,38,84,,
"Lubczynski, Rafal",34,50,84,,
"Lokander, Martin",45,39,84,,
"Obgolts, Erik",43,41,84,,
"Rigo, Janos",44,40,84,,
"Schmidt, Peter",40,44,84,,
"Goodman, David SC",39,45,84,,
"Vera Siguenas, Deivy",44,40,84,,
"Muhutdinov, Marat",35,49,84,,
"Kalashian, David",40,44,84,,
"Kosikov, Alexey I.",38,46,84,,
"Reggio, Arturo",43,41,84,,
"Pritchard, David Brine",43,41,84,,
"Pezerovic, Edin",39,45,84,,
"Wang, Shixu B.",45,39,84,,
"Donaldson, John W.",36,48,84,,
"Servat, Roberto",38,45,83,,
"Maximov, Dmitry",40,43,83,,
"Duzhakov, Ilya",39,44,83,,
"Schwabeneder, Florian",43,40,83,,
"Kumaran, Dharshan",46,37,83,,
"Thelen, Bedrich",37,46,83,,
"Amar, Elham",41,42,83,,
"Helmertz, Per-Inge",41,42,83,,
"Sheng, Joshua",45,38,83,,
"Regedzinski, Teodor",49,34,83,,
"Szalanczy, Emil",36,47,83,,
"Petrosyan, Tigran S.",37,46,83,,
"Perske, Thore",44,39,83,,
"Goldenberg, Edgardo",43,40,83,,
"Poliak, Evsey",39,44,83,,
"Grishchenko, Sergey",40,43,83,,
"Hanauer, Milton Loeb",45,37,82,,
"Stupica, Janez",42,40,82,,
"Pollock, William",40,42,82,,
"Gonzalez Rodriguez, Jorge A.",44,38,82,,
"Goldenov, Boris P.",42,40,82,,
"Balcarek, Wiktor",42,40,82,,
"Mas, Hafizulhelmi",38,44,82,,
"Zou, Chen",42,40,82,,
"Janata, Michael",44,38,82,,
"Lagunow, Alexander",36,46,82,,
"Madl, Ildiko",37,45,82,,
"Alvarez Ibarra, Rafael",32,50,82,,
"De la Bourdonnais, Louis C.",44,38,82,,
"Sokolin, Leonid M.",46,36,82,,
"Mitenkov, Alexey",45,37,82,,
"Weinstein, Raymond",42,40,82,,
"Richter, Emil",42,39,81,,
"Hutchings, Stuart J.",42,39,81,,
"Neelash, Saha",38,43,81,,
"Lodhi, Mahmood",45,36,81,,
"Akhmadeev, Vadim",40,41,81,,
"Christoffel, Martin",40,41,81,,
"Klima, Lukas",41,40,81,,
"Biriescu, Ioan",45,36,81,,
"Janovsky, Sergey",42,39,81,,
"Platz, Hans",42,39,81,,
"Fedorov, Vladislav",34,47,81,,
"Kaenel, Hansjuerg",34,47,81,,
"Scheipl, Ralf",41,40,81,,
"Szabo, Stefan",38,43,81,,
"Kutuzovic, Branko",43,38,81,,
"Hodges, Albert B.",40,41,81,,
"Berdayes Ason, Dylan Isidro",44,36,80,,
"Kirillov, Vladimir G.",40,40,80,,
"Lukic, Arsenije",40,40,80,,
"Ousatchi, Mark",45,35,80,,
"Candela Perez, Jose",38,42,80,,
"Vasilevich, Tatjana",38,42,80,,
"Ratkovic, Milovan",36,44,80,,
"Podolchenko, Evgeniy",35,45,80,,
"Garcia Ramos, Daniel",44,36,80,,
"Rosino, Antonio",39,41,80,,
"Fromm, Marius",40,40,80,,
"Lanin, Alexsej",36,44,80,,
"Fernando, Diogo",39,41,80,,
"Lai, Hing Ting",37,43,80,,
"Thorfinnsson, Bjorn",37,43,80,,
"Pedersen, Karl",38,42,80,,
"Mirzoev, Emil",41,39,80,,
"Markovic, Ivan J.",39,41,80,,
"Reyes, Juan",33,47,80,,
"Ghazarian, Kirk",38,42,80,,
"Ortega Amarelle, Mariano",38,42,80,,
"Daghli, Arash",42,38,80,,
"Song, Raymond",40,40,80,,
"Pena Gomez, Manuel",38,42,80,,
"Abdrlauf, Elham",37,43,80,,
"Rajna, George",37,43,80,,
"Garbisu de Goni, Unai",40,40,80,,
"Armas, Julius",45,35,80,,
"Markgraf, Alexander",43,37,80,,
"Bohosjan, Sarkis",37,42,79,,
"Petrov, Jole",43,36,79,,
"Georgescu, Vasile-Maxim",39,40,79,,
"Ibrayev, Nurlan",45,34,79,,
"Golizadeh, Asghar",46,33,79,,
"Cooper, John Grantley",41,38,79,,
"Remizov, Yaroslav",41,38,79,,
"Kopaev, Nikolay A.",41,38,79,,
"Brostrom, Goran",43,36,79,,
"Graf, Felix",39,40,79,,
"Reich, Thomas",39,40,79,,
"Norri, Joose",37,42,79,,
"Gasthofer, Alexander",32,47,79,,
"Fakhrutdinov, Timur",38,41,79,,
"Guo, Arthur",39,40,79,,
"Amos, Bruce M.",44,35,79,,
"Yukhtman, Yakov",37,42,79,,
"Pelts, Roman",42,37,79,,
"Grynfeld, Izaak",41,38,79,,
"Alonso Moyano, Jonathan",37,42,79,,
"Zvorykina, Kira",41,38,79,,
"Radashkovich, Itchak",42,37,79,,
"Kilic, Eray",44,35,79,,
"Post, Ehrhardt",39,40,79,,
"Scekic, Milos",37,42,79,,
"Prizant, Jaroslav",37,41,78,,
"Camacho Collados, Marcos",38,40,78,,
"Plazuelo Pascual, Juan",41,37,78,,
"Looshnikov, Nikolai",32,46,78,,
"Altounian, Levon",35,43,78,,
"Fernandez Guillen, Ernesto J.",36,42,78,,
"Mann, Christian",38,40,78,,
"Silva, Fernando",34,44,78,,
"Vestol, Aage",40,38,78,,
"Korbut, Ekaterina",46,32,78,,
"Mesaros, Florian",34,44,78,,
"Sanchez Almeyra, Jorge",38,40,78,,
"Pugach, Mario",41,37,78,,
"Nadera, Barlo A.",37,41,78,,
"Raaste, Eero J.",48,30,78,,
"Mukhametov, Eldar",35,43,78,,
"Campos Lopez, Mario",42,36,78,,
"Negyesy, Gyorgy",39,39,78,,
"Nickoloff, Bryon",42,36,78,,
"Roessel, Fritz",40,37,77,,
"Aldama Degurnay, Dionisio",33,44,77,,
"Finek, Vaclav",38,39,77,,
"Bitalzadeh, Ali",40,37,77,,
"Isaev, Jamshed",35,42,77,,
"Gossip, George",39,38,77,,
"Meyer, Eugene B.",39,38,77,,
"Hanham, James Moore",36,41,77,,
"Pruess, David",45,32,77,,
"Weinzettl, Ernst",40,37,77,,
"Begovac, Franja",38,39,77,,
"Roshka, Yevgeniy",37,40,77,,
"Stepak, Yedael",40,37,77,,
"Shmeliov, Denis",34,43,77,,
"Bakulin, Nikolac I.",38,39,77,,
"Nun, Josef",38,39,77,,
"Rzayev, Bahruz",38,39,77,,
"Watson, John L.",31,46,77,,
"Schulz, Klaus-Juergen",39,38,77,,
"Pogosyan, Stefan",40,37,77,,
"Feuerstein, Arthur",39,38,77,,
"Makhmutov, Rail",42,35,77,,
"Mikac, Matjaz",36,41,77,,
"Blackstock, Lesly SF",34,43,77,,
"Gauglitz, Gernot",38,39,77,,
"Piesik, Piotr",39,37,76,,
"Silman, Jeremy D.",40,36,76,,
"Geller, Uzi",38,38,76,,
"Seyb, Alexander",36,40,76,,
"Glauser, Hansruedi",36,40,76,,
"Fus, Jakub",40,36,76,,
"Whitehead, Jay E.",36,40,76,,
"Schneider, Bernd1",37,39,76,,
"Schuster, Theodor",40,36,76,,
"Rantanen, Matti",37,39,76,,
"Bradford, Joseph M.",36,40,76,,
"Samusenko, Maksim",35,41,76,,
"Lederman, Leon",36,40,76,,
"Mu, Ke",37,39,76,,
"Garza Marco, Sergio",37,39,76,,
"Yeoh, Li Tian",42,34,76,,
"Ten Hertog, Hugo",38,38,76,,
"Gorovykh, Eduard",40,36,76,,
"Wegener, Olaf",40,36,76,,
"Berkvens, Joost",38,38,76,,
"Cukrowski, Filip",42,34,76,,
"Mesropov, Konstantin",36,40,76,,
"Injac, Teodora",34,42,76,,
"Shetty, A.",39,37,76,,
"Ellers, Holger",32,44,76,,
"Claesen, Pieter",39,37,76,,
"Ludgate, Alan",38,38,76,,
"Arab, Adlane",39,36,75,,
"Saulin, Dmitri",35,40,75,,
"Cardoso Cardoso, Jose Gabriel",38,37,75,,
"Ribeiro, Joao Mario",40,35,75,,
"Dobias, Josef",36,39,75,,
"Milovanovic, Rade",35,40,75,,
"Welin, Thomas",39,36,75,,
"Barda, Olaf",37,38,75,,
"Leskur, Dejan",32,43,75,,
"Sakelsek, Tadej",37,38,75,,
"Genba, Vladimir",37,38,75,,
"Cantero, Ronaldo",38,37,75,,
"Gurevich, Daniel",40,35,75,,
"Stets, Dmitry",39,36,75,,
"Eismont, Oleg",38,37,75,,
"Nagy, Ervin",41,34,75,,
"Zara, Dan",34,41,75,,
"Wolf, Siegfried",39,36,75,,
"Naegeli, Oskar",35,40,75,,
"Berry, Jonathan",36,39,75,,
"Kabatianski, Alexander",36,39,75,,
"Cochrane, John Miles",46,28,74,,
"Martinez Ramirez, L.",35,39,74,,
"Harvey, Marcus R.",41,33,74,,
"Smailbegovic, Hasan",38,36,74,,
"Kiewra, Keaton F.",34,40,74,,
"Tsolakidou, Stavroula",43,31,74,,
"Szekely, Jeno",34,40,74,,
"Beyen, Roland",41,33,74,,
"Grabliauskas, Virginijus",41,33,74,,
"Riemann, Fritz",37,37,74,,
"Gelman, Alexander",40,34,74,,
"Filguth, Rubens Alberto",40,34,74,,
"Bakalchuk, Johnatan",36,38,74,,
"Lacasa Diaz, Jose Antonio",37,37,74,,
"Dobrzynski, Wojciech",29,45,74,,
"Cuhendi, Sean Winshand",39,35,74,,
"Burnoiu, Nicolae-Costel",41,33,74,,
"Lowcki, Moishe L.",37,37,74,,
"Bakonyi, Elek",37,37,74,,
"Balcerak, Jakob",34,40,74,,
"Berchtenbreiter, Maximilian",43,31,74,,
"Markoja, Boris",35,39,74,,
"Popov, Nikolay",36,38,74,,
"Reshko, Aron G.",36,38,74,,
"Daggupati, Balaji",37,37,74,,
"Babaev, Rashad",34,40,74,,
"Morawietz, Dieter",29,45,74,,
"Alavi, Sayed Javad",31,43,74,,
"Serwinski, Benedykt",35,39,74,,
"Joachim, Sven",32,42,74,,
"Michaelsen, Nils",44,30,74,,
"Kosanski, Stanko",36,37,73,,
"Engqvist, Thomas",39,34,73,,
"Aronson, Lev",35,38,73,,
"Sorensen, Hampus",37,36,73,,
"Gadalinski, Jan",32,41,73,,
"Karklins, Andrew",39,34,73,,
"Jepson, Christian",39,34,73,,
"Levin, Jacob",33,40,73,,
"Olexa, Vilem",38,35,73,,
"Atanasov, Petko",31,42,73,,
"Krabbe, Tim",39,34,73,,
"Lingnau, Carsten",33,40,73,,
"Soltanici, Ruslan",35,38,73,,
"Farah, Rodolfo",38,35,73,,
"Tomaszewski, Roman",35,38,73,,
"Makarov, Andrei",38,35,73,,
"Shishov, Mikhail Vasilievich",39,34,73,,
"Wiersma, Eelke",38,35,73,,
"Sulashvili, Malkhaz",38,35,73,,
"Harikrishnan, A. Ra",32,41,73,,
"Vukovic, Vladimir",38,35,73,,
"Maedler, Juergen",38,35,73,,
"Schlage, Willi",41,32,73,,
"Von Holzhausen, Walther",41,32,73,,
"Alzate, Dario",33,40,73,,
"Grinberg, Ricardo",37,36,73,,
"Kristjansson, Bragi",38,35,73,,
"Levitsky, Stepan M.",36,37,73,,
"Weenink, Henri",36,37,73,,
"Telljohann, Sven",39,34,73,,
"Marholev, Dimitar",26,46,72,,
"Milliet, Sophie",38,34,72,,
"Baum, Jonasz",40,32,72,,
"Molina, Julio",36,36,72,,
"Karavade, Eesha",27,45,72,,
"Chasin, Nico",37,35,72,,
"Walter, Guenter",36,36,72,,
"Pustina, Ylvi",39,33,72,,
"Pinzon Solis, Felipe",34,38,72,,
"Housieaux, David",34,38,72,,
"Nikolovski, Nikola",31,41,72,,
"Lengyel, Bela",41,31,72,,
"Rautenberg, Wilhelm",40,32,72,,
"Maki, Veijo",35,37,72,,
"Shvayger, Yuliya",34,38,72,,
"Bonin, Jay R.",36,36,72,,
"Heimann, M.",39,33,72,,
"Libeau, Rene Andre",34,38,72,,
"Hanley, Craig A.",30,42,72,,
"Cappello, Guido",37,35,72,,
"Walter, Max",40,32,72,,
"Celik, Hasan Huseyin",34,37,71,,
"Silva Nazzari, Roberto",30,41,71,,
"Garcia Pantoja, Roberto",35,36,71,,
"Farre Mallofre, Miguel",40,31,71,,
"Gasic, Bozidar",31,40,71,,
"Kargin, Arseny",33,38,71,,
"Chernov, Vadim",35,36,71,,
"Schauwecker, Meinrad",31,40,71,,
"Szeberenyi, Adam",39,32,71,,
"Jamieson, Peter Michael",35,36,71,,
"Merry, Alan B.",31,40,71,,
"Trikaliotis, Georgios",36,35,71,,
"Moles, John",30,41,71,,
"Regan, Kenneth",31,40,71,,
"Gragger, Anton Fritz",36,35,71,,
"Grigorian, Levon Ashotovich",31,40,71,,
"Berbatov, Kiprian",39,32,71,,
"Godart, Francois",40,31,71,,
"Martin Duque, Jesus",42,29,71,,
"Oblitas, Carlomagno",32,39,71,,
"Willemze, Thomas",28,43,71,,
"Jezek, Stanislav",30,41,71,,
"Ider, Borya",34,37,71,,
"Godoy Bugueno, David Arturo",40,30,70,,
"Kvon, Andrey",30,40,70,,
"Krantz, Kjell",40,30,70,,
"Van Dop, Arend J.",33,37,70,,
"Barasz, Zsigmond",33,37,70,,
"Sardana, Rishi",27,43,70,,
"Mitusov, Semen",34,36,70,,
"Ozen, Deniz",37,33,70,,
"Hess, Ralf E.",36,34,70,,
"Duboue, Peio",42,28,70,,
"Tsesarsky, Ilya",35,35,70,,
"Caro, Alberto N.",33,37,70,,
"Grinshpun, Eduard",39,31,70,,
"Ilievski, Dimitar",33,37,70,,
"Ljavdansky, Vladimir",34,36,70,,
"Scanavino, Eduardo",35,35,70,,
"Bachmann, Karlheinz",37,32,69,,
"Mazel, Isaak Y.",30,39,69,,
"Wilhelmi, Christian",32,37,69,,
"Frolov, Denis",36,33,69,,
"Kiss, Pal",38,31,69,,
"Costa, Jean-Luc",34,35,69,,
"Rumens, David E.",36,33,69,,
"Rathanvel, VS",26,43,69,,
"Kuyindzhi, Alexander A.",32,37,69,,
"Toth, Peter",36,33,69,,
"Muhring, Willem Jan",30,39,69,,
"Seger, Ruediger",39,30,69,,
"Philippe, Christophe",41,28,69,,
"Gomez Ledo, Roberto Carlos",32,37,69,,
"Flores Rios, Mauricio",35,34,69,,
"Katetov, Miroslav",35,34,69,,
"Rydl, Jiri",37,32,69,,
"Jugelt, Tobias",33,36,69,,
"Larkin, Vladyslav",32,37,69,,
"Povah, Nigel E.",33,36,69,,
"Kardashevskiy, Evgeny",34,35,69,,
"Certic, Branimir",45,24,69,,
"Ziembinski, Marian",35,34,69,,
"Godes, Dmitry R.",35,34,69,,
"Nyholm, Gustav",37,32,69,,
"Pulpan, Jakub",35,34,69,,
"Lapienis, Donatas",39,30,69,,
"Pardo Simon, David",37,31,68,,
"Deuer, Marius",33,35,68,,
"Zabotin, Alexander",31,37,68,,
"Sagalchik, Gennadij",40,28,68,,
"Ceres, Dragos",31,37,68,,
"Tumurbator, Purev",39,29,68,,
"Paikidze, Nazi",33,35,68,,
"Bregadze, Levan",28,40,68,,
"Baikov, Vladimir A.",36,32,68,,
"Ghimpu, Samuel-Timotei",38,30,68,,
"Bjork, Carl-Magnus",35,33,68,,
"Sebastian, Dirk",34,34,68,,
"Sklyarov, Dmitry V.",36,32,68,,
"Dobrev, Nanko",33,35,68,,
"Jackelen, Thomas",37,31,68,,
"Slugin, Sergey",32,36,68,,
"Simonovic, Borko",34,34,68,,
"Romi, Massimiliano",31,37,68,,
"Bjerre, Troels",40,28,68,,
"Bar, Roman",28,40,68,,
"Ninov, Kiril",29,39,68,,
"Hesham, A.",29,39,68,,
"Delemarre, Jop",37,31,68,,
"Moreno Trujillo, Alejandro",37,31,68,,
"Herink, Miroslav",33,35,68,,
"Korelov, Alexander P.",35,33,68,,
"Peyrer, Konstantin",34,34,68,,
"Ziegler, Ari",35,32,67,,
"Aronyak, Ghosh",30,37,67,,
"Grushevsky, Alexander V.",37,30,67,,
"Kiffmeyer, Constanz",29,38,67,,
"Tan, Hiang Liong",37,30,67,,
"Argandona Riveiro, Inigo",34,33,67,,
"Friedgood, David",29,38,67,,
"Jaeger, Walter",33,34,67,,
"Van Vliet, Louis",32,35,67,,
"Cafure, Emilio",37,30,67,,
"Chepukaitis, Genrikh",37,30,67,,
"Horner, Jeff",34,33,67,,
"Korobkov, Piotr",30,37,67,,
"Lovkov, Roman",32,35,67,,
"Vydeslaver, Alik",31,36,67,,
"Sariego, Wilfredo",38,29,67,,
"Andres Gonzalez, Alberto",33,34,67,,
"Kirk, Ezra",33,34,67,,
"Vogel, Jaap",32,35,67,,
"Barseghyan, Harutyun",35,32,67,,
"Abdurakhmonov, Mukhammadali",29,38,67,,
"Nordstrom, Felix",35,32,67,,
Harshavardhan GB,35,32,67,,
"Barp, Alberto",38,29,67,,
"West, Guy",27,40,67,,
"Bergstrom, Christer",33,34,67,,
"Van Delft, Merijn",35,32,67,,
"Colin, Vincent",33,34,67,,
"Smetankin, Stanislav",32,35,67,,
"Mariano, Nelson",32,35,67,,
"Obolenskikh, Dmitry",31,36,67,,
"Wachinger, Nikolas",32,34,66,,
"Levin, Mikhail",31,35,66,,
"De la Vega, Hector",31,35,66,,
"Kaplan, Sasha",36,30,66,,
"Suyarov, Mukhammadzokhid",34,32,66,,
"Wolk, Sigmund",35,31,66,,
"Cawdery, Daniel",31,35,66,,
"Zinner, Emil",30,36,66,,
"Solmundarson, Magnus",35,31,66,,
"Strauss, David J.",35,31,66,,
"Arlamowski, Edward",33,33,66,,
"Kopylov, Alexander A.",34,32,66,,
"Suradiradja, Herman",33,33,66,,
"Titov, German",35,31,66,,
"Sallay, Roland",32,34,66,,
"Fargere, Francois",26,40,66,,
"Lemmers, Oscar",28,38,66,,
"Beilin, Mikhail Abramovich",34,32,66,,
"Dementiev, Oleg I.",32,34,66,,
"Ware, Preston",34,32,66,,
"Volovich, Anatoly A.",31,35,66,,
"Danielsson, Gosta",30,36,66,,
"Minzer, Claudio Javier",33,33,66,,
"Wang, K.",30,36,66,,
"Khalilbeili, Sultan",32,34,66,,
"Bergraser, Volf",32,34,66,,
"Trincardi, Tullio",34,32,66,,
"Braeuer, Franz",30,36,66,,
"Setyaki, Azarya Jodi",30,36,66,,
"Davidson, Jacques",33,33,66,,
"Ufimtsev, Anatoly",34,32,66,,
"Carvalho, Herbert Abreu",27,39,66,,
"Philippe, Georges",35,31,66,,
"Armas Gutierrez, Jorge Enrique",31,35,66,,
"Tapaszto Binet, Laszlo",34,32,66,,
"Szollosi, Laszlo Sr",33,32,65,,
"Borocz, Istvan",32,33,65,,
"Littleton, Michael Flannan",29,36,65,,
"Balparda, Julio Cesar",33,32,65,,
"Kchouk, Bechir",30,35,65,,
"Pokazanjev, Nikolai",32,33,65,,
"Mittelman, Gur",27,38,65,,
"Musil, Vojko",32,33,65,,
"Spirin, Oleg",27,38,65,,
"Vetokhin, Savva",33,32,65,,
"Wong, Meng Kong",31,34,65,,
"Prithu, Gupta",34,31,65,,
"Corral Blanco, Juan Antonio",31,34,65,,
"Valenzuela Fuentealba, Luis",30,35,65,,
"Isik, Alparslan",34,31,65,,
"Li, Zunian",32,33,65,,
"Capelan, Guenter",32,33,65,,
"Winter, Irene",26,39,65,,
"Bukhman, Eduard",28,37,65,,
"Vlasenko, Miroslav",31,34,65,,
"Dobrovolsky, Ladislav",30,35,65,,
"Murugan, Krishnamoorthy",32,33,65,,
"Kuettner, Uwe",28,37,65,,
"Izzat, Kanan",30,35,65,,
"Moreno Tejera, Emilio",31,33,64,,
"Kristiansen, Erling",31,33,64,,
"Gutman, Gennadi",35,29,64,,
"Weise, Dieter",30,34,64,,
"Idigoras Guisasola, Gregorio",32,32,64,,
"Berndtsson Kullberg, Karl",26,38,64,,
"Popov, Sinisa S.",32,32,64,,
"Bromann, Thorbjorn",35,29,64,,
"Dzyuban, Oleg",33,31,64,,
"Humerez Estrada, Cidar",33,31,64,,
"Askarov, Marat",32,32,64,,
"MacDonnell, George",36,28,64,,
"Christoph, Manfred",32,32,64,,
"Gudmundsson, Arinbjorn",34,30,64,,
"Duong, The Anh",31,33,64,,
"Arulaid, Alexander",26,38,64,,
"Bergez, Luc",30,34,64,,
"De Carvalho, Flavio",30,34,64,,
"Taborov, Boris",34,30,64,,
"Rozen, Eytan",33,31,64,,
"Smirnov, Igor",32,32,64,,
"Virovlansky, Semen",32,32,64,,
"Payen, Arnaud",22,42,64,,
"Pira, Davoud",38,26,64,,
"Baratosi, Daniel",34,30,64,,
"Herzog, Adolf",31,33,64,,
"Bluemich, Max",37,27,64,,
"Yang, Kaiqi",34,30,64,,
"Csulits, Anton",31,32,63,,
"Piscopo, Pierluigi",32,31,63,,
"Passerotti, Pierluigi",31,32,63,,
"Reichenbach, Werner",33,30,63,,
"Shamaev, Leonid",30,33,63,,
"Lomineishvili, Maia",33,30,63,,
"Psyk, Radoslaw",38,25,63,,
"Li, Yankai",31,32,63,,
"Buturin, Vladimir",31,32,63,,
"Falcon, Enrique",30,33,63,,
"Villarroel, Geber",31,32,63,,
"Haahr, Thorkild",32,31,63,,
"Soloviev, Vladimir A.",30,33,63,,
"Zude, Erik",34,29,63,,
"Yap, Andronico",33,30,63,,
"Osterman, Rudolf",26,37,63,,
"Huguet, Bernard",34,29,63,,
"Mueller, Matthias",30,33,63,,
"Auchenberg, Per",33,30,63,,
"Muratov, Vladimir A.",30,33,63,,
"David, Alexandru",35,28,63,,
"Botez, Constantin",37,26,63,,
"Grechkin, Dmitry Makarovich",32,31,63,,
"Kofidis, Andreas",31,32,63,,
"Khatanbaatar, Bazar",30,33,63,,
"Wockenfuss, Klaus",33,30,63,,
"Daskalov, Georgi",31,32,63,,
"Kudriashov, Anatoli",31,32,63,,
"Haddouche, Mohamed",28,35,63,,
"Golmayo de la Torriente, Manuel",31,32,63,,
"Altschul, Milos",29,34,63,,
"Amanov, Mesgen",26,37,63,,
"Soultanbeieff, Victor I.",34,29,63,,
"Shestoperov, Aleksej",27,36,63,,
"Napolitano, Mario",35,28,63,,
"Papa, Severin",32,30,62,,
"Divya, Deshmukh",31,31,62,,
"Rorvall, Goran",28,34,62,,
"Milman, Lev",29,33,62,,
"Schottlaender, Arnold",26,36,62,,
"Rubio Mejia, Luis Ignacio",37,25,62,,
"Lorenzini, Martin",31,31,62,,
"Rodin, Dmitrij",30,32,62,,
"Koop, Thorben",29,33,62,,
"Ranniku, Maaja",30,32,62,,
"Roser, Kevin",29,33,62,,
"Szoen, Dariusz",32,30,62,,
"Platt, Josef",29,33,62,,
"Ronchetti, Niccolo",35,27,62,,
"Muse, Drazen",27,35,62,,
"Pablo Mari, Alejandro",31,31,62,,
"Kanter, Eduard",39,23,62,,
"Anelli, Antonio",31,31,62,,
"Maltsevskaya, Aleksandra",31,31,62,,
"Anton, Teodor",29,33,62,,
"Jenei, Ferenc",33,29,62,,
"Svensson, Bengt",32,30,62,,
"Nedobora, Mikhail",32,30,62,,
"Papadopoulos, Ioannis",31,31,62,,
"Zulfugarli, Magomed",24,38,62,,
"Gschnitzer, Adrian",33,29,62,,
"Patel, Advait",32,30,62,,
"Simonson, Albert",34,28,62,,
"Brody, Miklos",31,30,61,,
"Chuprikov, Dmitry",26,35,61,,
"Kaldor, Avraham",32,29,61,,
"Sharapov, Evgeny",27,34,61,,
"Tsaruk, Maksim",30,31,61,,
"Cori Quispe, Kevin Joel",22,39,61,,
"Makkar, Rajat",24,37,61,,
"Esser, Johannes",34,27,61,,
"Gamundi Salamanca, Antonio",31,30,61,,
"Kanko, Ilkka",34,27,61,,
"Estremera Panos, Sergio",30,31,61,,
"Astaneh Lopez, Alex",34,27,61,,
"Gunsberger, Alexander",30,31,61,,
"Aghasaryan, Robert",29,32,61,,
"Monroy, Charles",29,32,61,,
"Bruk, Ofer",28,33,61,,
"Irwanto, Sadikin",30,31,61,,
"Berger, Bela",33,28,61,,
"Kulicov, Oleg",27,34,61,,
"Just, Gabriele",29,32,61,,
"Morris, James",34,27,61,,
"Taruffi, Daniele",30,31,61,,
"Katz, Alexander R.",32,29,61,,
"Dankert, Peter",28,33,61,,
"Costa, Leonardo",34,27,61,,
"Haubro, Martin",32,29,61,,
"Onat, Ilhan",28,33,61,,
"Berkovich, Mark A.",30,31,61,,
"Barreras, Alberto",32,29,61,,
"Colon Romero, Miguel",31,29,60,,
"Bjelajac, Milan",32,28,60,,
"Chellstorp, Craig V.",26,34,60,,
"Beukema, Stefan",26,34,60,,
"Kokkoris, Hristos",33,27,60,,
"Flamberg, Alexander D.",28,32,60,,
"Peresipkin, Vladimir",29,31,60,,
"Novkovic, Milan",32,28,60,,
"Kuzminykh, Evgeny",31,29,60,,
"Pitschel, Karl",26,34,60,,
"Terpugov, Evgeny",32,28,60,,
"Polaczek, Richard",36,24,60,,
"Shukh, Nikolai",30,30,60,,
"Slovineanu, Viacheslav",27,33,60,,
"Akbas, Umut Ata",25,35,60,,
"Lekander, Rolf",26,34,60,,
"Suarez Garcia, Carlos",34,26,60,,
"Gliksman, Darko",25,35,60,,
"Wisker, John",30,30,60,,
"Marinelli, Tullio",26,34,60,,
"Gajek, Radoslaw",25,35,60,,
"Romani, Elio",32,28,60,,
"Thorvaldsson, Jonas",28,32,60,,
"Tiglon, Bryce",31,29,60,,
"Llanos, Guillermo",35,25,60,,
"Bass, Leonid",28,32,60,,
"Trompowsky, Octavio SF",31,29,60,,
"Roth, Rolf",29,31,60,,
"Muco, Fatos",28,31,59,,
"Mozny, Milos",23,36,59,,
"Macdonald-Ross, Michael",27,32,59,,
"Dancevski, Orce",32,27,59,,
"Beutum, Sigmund",27,32,59,,
"Handel, Horst",30,29,59,,
"Ynojosa Aponte, Felix Jose",31,28,59,,
"Ostrovskiy, Andrey",27,32,59,,
"Phillips, Alan",33,26,59,,
"Zarubin, Pavel",26,33,59,,
"Pugachov, Alexey",30,29,59,,
"Meulders, Richard",30,29,59,,
"Meitner, Philipp",29,30,59,,
"Martinez, Dion M.",29,30,59,,
"Nielsen, Bjorn",29,30,59,,
"Battulga, Namkhai",33,26,59,,
"Djordjevic, Vuk",30,29,59,,
"Preinfalk, Anton",29,30,59,,
"Woodhams, Michael",25,34,59,,
"Szymanski, Marcin",31,28,59,,
"Giterman, Shlomo",28,31,59,,
"Karpman, Vadim",24,35,59,,
"Karakehajov, Kalin",31,28,59,,
"Mozes, Ervin",30,29,59,,
"Gutov, Andrey",31,28,59,,
"Utasi, Tamas",29,30,59,,
"Blagidze, Alexander",29,30,59,,
"Sitnikov, Dmitrij",25,34,59,,
"Shereshevski, Mikhail",27,32,59,,
"Voiculescu, Paul",26,33,59,,
"Eliseev, Alexey",31,28,59,,
"Marinkovic, Slavisa",27,32,59,,
"Vega Gutierrez, Sabrina",28,31,59,,
"Tavares da Silva, Luiz",28,31,59,,
"Aleman Dovo, Miguel",32,27,59,,
"Rosell, Kaj",24,35,59,,
"Liiva, Riho",35,24,59,,
"Perez Alcocer, Jose",30,29,59,,
"Solomon, Kenny",26,33,59,,
"Hresc, Vladimir",32,27,59,,
"Green, Ewen M.",32,27,59,,
"Root, Douglas",29,30,59,,
"Bengtsson, Bo",30,29,59,,
"Mazi, Leon",34,25,59,,
"Camara, Ronald",27,32,59,,
"Poch, Cesar Guillermo",28,30,58,,
"Purdy, Cecil John Seddon",33,25,58,,
"Hamilton, Douglas Gibson",31,27,58,,
"Wallis, Philip N.",29,29,58,,
"Lunev, Andrey",27,31,58,,
"Llanes Hurtado, Miguel",28,30,58,,
"Pantaleev, Dimitar",31,27,58,,
"Sommerbauer, Norbert",24,34,58,,
"Isanzhulov, Arystan",28,30,58,,
"Goumas, Georgios",27,31,58,,
"Morozov, N.",26,32,58,,
"Smirnov, Alexey",28,30,58,,
"Soysal, Serkan",24,34,58,,
"Codenotti, Marco",24,34,58,,
"Cristia, Jose Maria",31,27,58,,
"Maslov, Leonid P.",30,28,58,,
"Matisons, Hermanis",25,33,58,,
"Krstulovic, Alex",24,34,58,,
"Zemlyanskii, Ivan",33,25,58,,
"Qin, Kanying",27,31,58,,
"Swic, Waldemar",31,27,58,,
"Amado, Claudio",29,29,58,,
"Gilden, Lawrence C.",25,33,58,,
"Casa, Alex",30,28,58,,
"Levin, Guy",26,32,58,,
"Grigorian, Spartak",25,33,58,,
"Romm, Meir",25,33,58,,
"Bakic, Rados",29,29,58,,
"Liebstein, Arturo",29,29,58,,
"Ozols, Karlis",26,32,58,,
"Bashkov, Viacheslav",26,32,58,,
"Mindlin, Alon",27,31,58,,
"Machate, Gottlieb",29,29,58,,
"Valderrama Quiceno, Esteban Alb",32,26,58,,
"Labib, Ibrahim Hasan",26,32,58,,
"Zorko, Jure",26,32,58,,
"Raisa, Unto",30,28,58,,
"Bayer, Bernhard",24,34,58,,
"Von Herman, Ulf",31,26,57,,
"Kaczmarczyk, Dennis",34,23,57,,
"Anderson, Frank Ross",26,31,57,,
"Ravi, Thandalam Shanmugam",23,34,57,,
"Krueger, Paul",27,30,57,,
"Rudakovsky, Iosif",30,27,57,,
"Perez Gormaz, Matias",29,28,57,,
"Malek, Jan",31,26,57,,
"Lynch, Julio",29,28,57,,
"Zivkovic, Vjekoslav",26,31,57,,
"Martens, Martin",31,26,57,,
"Tomic, Bosko",27,30,57,,
"Drnovsek, Gal",28,29,57,,
"Astrom, Robert",29,28,57,,
"Vinje Gulbrandsen, Arne",29,28,57,,
"Saren, Ilkka J.",24,33,57,,
"Jurkovic, Hrvoje",30,27,57,,
"Webster, Andrew A.",26,31,57,,
"Gerber, Richard",25,32,57,,
"Golichenko, Ilija",30,27,57,,
"Malakhov, Igor",28,29,57,,
"Halvax, Georg",29,28,57,,
"Junge, Klaus",26,31,57,,
"Droin, Augustin",27,30,57,,
"Semenova, Lidia K.",31,26,57,,
"Safvat, Younus",31,26,57,,
"Heuer, Valter",32,25,57,,
"Pavey, Max",31,26,57,,
"Taher, Yoseph Theolifus",25,32,57,,
"Agibileg, Uurtsaikh",30,27,57,,
"D'Cunha, Viani Antonio",26,31,57,,
"Santa Cruz, Hugo",29,28,57,,
"Diaz Hollemaert, Nahuel",25,32,57,,
"Votruba, Pavel",28,28,56,,
"Isajevsky, Anton",28,28,56,,
"Sorensen, Bent",28,28,56,,
"Haimovich, Tal",32,24,56,,
"Mardov, Dimitar",27,29,56,,
"Wright, Daniel",25,31,56,,
"Barria Zuniga, Daniel",27,29,56,,
"Galinsky, Timofey",24,32,56,,
"Borm, Frans",29,27,56,,
"Ajrapetjan, Yuriy",26,30,56,,
"Wittek, Alexander",27,29,56,,
"Merario Alarcon, Andres",26,30,56,,
"Atakisi, Umut",23,33,56,,
"Sergievsky, Vladimir D.",27,29,56,,
"Fraguela Gil, Jose M.",28,28,56,,
"Kobylkin, Evgeni",29,27,56,,
"Fang, Yan",25,31,56,,
"Djaja, Dragutin",28,28,56,,
"Cruz Lledo, Pablo",22,34,56,,
"Jukic, Mirko",25,31,56,,
"Zlatic, Mihajlo",27,29,56,,
"Podinic, Vladimir",30,26,56,,
"Abdel Razik, Khaled",28,28,56,,
"Ryc, Ivo",26,30,56,,
"Purtov, Andrei",26,30,56,,
"Spiess, Gunter",27,29,56,,
"Sammed Jaykumar, Shete",29,27,56,,
"Ustinov, Georgy I.",28,28,56,,
"Marchand, Max",29,27,56,,
"Radulescu, Mihai",26,30,56,,
"Pacan-Milej, Kosma",27,29,56,,
"Privara, Igor",25,31,56,,
"Mohammad Fahad, Rahman",29,27,56,,
"Vasiliev, Viktor A.",28,28,56,,
"Gothilf, Solomon Borisovich",32,24,56,,
"Simonenko, Sergey",27,29,56,,
"Moritz, Bruno",28,28,56,,
"Polivanov, Anatoliy",29,27,56,,
"Petrisor, Adrian-Marian",23,33,56,,
"Khukhashvili, Sopiko",31,25,56,,
"Rau, Hannes",29,27,56,,
"Ostmoe, Geir Sune Tallaksen",29,27,56,,
"Martynov, Pavel",26,30,56,,
"Broadbent, Reginald",29,27,56,,
"Samolins, Vitalijs",29,27,56,,
"Tabor, Jozsef",28,28,56,,
"Akshat, Khamparia",32,23,55,,
"Panczyk, Krzysztof",26,29,55,,
"Owen, John",30,25,55,,
"Lengyel, Laszlo",25,30,55,,
"Garibaldi, Oscar",28,27,55,,
"Ugrinovic, Dragan",26,29,55,,
"Spanjaard, Eduard",28,27,55,,
"Popovych, Orest",28,27,55,,
"Tejedor Fuente, Enrique",28,27,55,,
"Leussen, Benjamin",25,30,55,,
"Arslanov, Shamil",29,26,55,,
"Roos, Louis",24,31,55,,
"Gubajdullin, Alexei",24,31,55,,
"Samadov, Read",26,29,55,,
"Kukhmazov, Arsen",26,29,55,,
"Hollis, Adrian",25,30,55,,
"Ansell, Simon T.",23,32,55,,
"Berliner, Hans",23,32,55,,
"Asgarizadeh, Ahmad",28,27,55,,
"Kessler, Luca",23,32,55,,
"Szukszta, Janus",26,29,55,,
"Pour Agha Bala, Amirreza",26,29,55,,
"Kramer, Julian",20,35,55,,
"Devos, Paul",26,29,55,,
"Hrbek, Stepan",27,28,55,,
"Agdamus, Jose Luis",28,27,55,,
"Ruderfer, Mark B.",24,31,55,,
"Reinfeld, Fred",32,23,55,,
"Diu, Viacheslav",28,27,55,,
"Vareille, Francois",19,36,55,,
"Yip, Carissa",26,28,54,,
"Krastev, Alexander",29,25,54,,
"Samsonkin, Artiom",22,32,54,,
"Pelikian, Jefferson",23,31,54,,
"Karastoichev, Emil Stefanov",27,27,54,,
"Efroimski, Marsel",25,29,54,,
"Sabuk, Piotr",26,28,54,,
"Miranda, Marcio Marcos do Carmo",28,26,54,,
"Bogdan, Dan",25,29,54,,
"Wagner, Dinara",28,26,54,,
"Lipke, Paul",26,28,54,,
"Wotulo, Max Arie",29,25,54,,
"Ilamparthi, AR",32,22,54,,
"Calero, Ivan",26,28,54,,
"Hook, William",23,31,54,,
"Raizman, Maurice",26,28,54,,
"Pileckis, Emilis",23,31,54,,
"Ebeling, Daniel",27,27,54,,
"Kostolansky, Sebastian Lukas",27,27,54,,
"Vidonyak, Roman",21,33,54,,
"Mosionzhik, Ilya",24,30,54,,
"Agdelen, Huseyin Can",28,26,54,,
"Fridman, Rafael",26,28,54,,
"Atkins, Henry Ernest",28,26,54,,
"Tarhan, Adar",29,25,54,,
"Fernandez, A.",27,27,54,,
"Gerstenfeld, Eduard",27,27,54,,
"Foldi, Jozsef",26,28,54,,
"Reuker, Jari",29,25,54,,
"Barbulescu, Dan",24,30,54,,
"Todorovic, Jovan",25,29,54,,
"Orsag, Milan",26,28,54,,
"Ludwig, Daniel",28,26,54,,
"Schwarz, Jacques",28,25,53,,
"Nehmert, Ulrich",26,27,53,,
"Sanchez, Sebastian Felipe",24,29,53,,
"De Vere, Cecil Valentine",28,25,53,,
"Veinger, Itzhak",24,29,53,,
"Shatskes, Boris A.",25,28,53,,
"Pezelj, Novak",26,27,53,,
"Jimenez Fraga, Pedro Alejandro",21,32,53,,
"Ni, Shiqun",25,28,53,,
"Vinuesa, Juan",26,27,53,,
"Joppen, Egon",26,27,53,,
"De Lange, Daan",26,27,53,,
"Hempson, Peter W.",24,29,53,,
"Jensen, Vagn",27,26,53,,
"Schnider, Gert",29,24,53,,
"Norcia, Federico",30,23,53,,
"Xu, Minghui",24,29,53,,
"Wippermann, Till",25,28,53,,
"Grunberg, Sergiu-Henric",24,29,53,,
"Teufel, Juergen",26,27,53,,
"Czerwonski, Aleksander",22,31,53,,
"Pingin, Artem",25,28,53,,
"Peter, Ambrus",32,21,53,,
"Tinsley, Samuel",26,27,53,,
"Pozo Vera, Sandro",23,30,53,,
"Gross, David2",29,24,53,,
"Chojnacki, Krzysztof",33,20,53,,
"Soderborg, Berndt",29,24,53,,
"Hilse, Wilhelm H.",23,30,53,,
"Johansson, Jan",26,27,53,,
"Cech, Pavel",24,29,53,,
"Gasiorowski, Ryszard",27,26,53,,
"Kupreianov, George",25,27,52,,
"Kurenkov, Nikolai",18,34,52,,
"Ingerslev, Aage",24,28,52,,
"Labollita, Martin",30,22,52,,
"Henneberger, Walter",25,27,52,,
"Rotlewi, Georg A.",29,23,52,,
"Bernstein, Jacob",25,27,52,,
"Radlovacki, Jovan",29,23,52,,
"Winiwarter, Felix",24,28,52,,
"Krstic, Uros",21,31,52,,
"Nesterov, Yakov",22,30,52,,
"Litvinov, Vladimir",21,31,52,,
"Morris, Walter D.",24,28,52,,
"Klebel, Martin",26,26,52,,
"Heim, Sverre",22,30,52,,
"Pavlov, Maxim",26,26,52,,
"Garcia, Jan Emmanuel",23,29,52,,
"Pedersen, Christian Kyndel",24,28,52,,
"Palme, Rudolf",26,26,52,,
"Grafl, Florian",21,31,52,,
"Pinal Borges, Nelson",23,29,52,,
"Garbett, Paul Anthony",25,27,52,,
"Krysztofiak, Marcin",21,31,52,,
"Saigin, Vladimir",22,30,52,,
"Rechel, Bernd",26,26,52,,
"Adair, James R.",32,20,52,,
"Van Oosterom, Chiel",25,27,52,,
"Sjoberg, Victor",27,25,52,,
"Urbanec, Karel",26,26,52,,
"Jamroz, Zbigniew",27,25,52,,
"Stenborg, Ake",25,27,52,,
"Shahil, Dey",27,25,52,,
"Aleksic, Nenad1",26,26,52,,
"Berezin, Oleg",24,28,52,,
"Ben Ari, Yannay",23,29,52,,
"Namgilov, Sogto",22,30,52,,
"Rousseau, Eugene",25,26,51,,
"Sanz Aguado, Jose",24,27,51,,
"Pinto Paiva, Jose",25,26,51,,
"Dunnington, Angus J.",18,33,51,,
"Drvota, Antonin",25,26,51,,
"Piro, Valerio",25,26,51,,
"Lagunow, Raphael",25,26,51,,
"Berend, Fred",26,25,51,,
"Akhmetov, Artiom",25,26,51,,
"Blahynka, Martin",25,26,51,,
"Hofland, Leonard",26,25,51,,
"Sumiacher, Carlos",28,23,51,,
"McGrillen, Hugh",29,22,51,,
"Zaiatz, Elena",28,23,51,,
"Teplyi, Igor",26,25,51,,
"Bejtovic, Jasmin",22,29,51,,
"Badmatsyrenov, Oleg",24,27,51,,
"Albareda, Miguel Crues",25,26,51,,
"Grieve, Harry",29,22,51,,
"Packroff, Hermann",27,24,51,,
"Krause, Benedict",24,27,51,,
"Pavlenko, Oleg",24,27,51,,
"Semeniuk, Alexander A.",25,26,51,,
"Afromeev, Vladimir",28,23,51,,
"Agudelo, Antonio",25,26,51,,
"Rodgaard, John",27,24,51,,
"Hurme, Harri M.",23,28,51,,
"Gochelashvili, David",30,21,51,,
"Orev, Petar",25,26,51,,
"Kucuksari, Kaan",25,26,51,,
"Gudmundsson, Gudbjartur",28,23,51,,
"Alarcon Casellas, Rolando",23,28,51,,
"Kirpichnikov, Vladimir S.",28,22,50,,
"Westermeier, Arnulf",22,28,50,,
"Puig Pulido, Pedro",22,28,50,,
"Tautvaisas, Povilas",23,27,50,,
"Schulz, Jan Sr",26,24,50,,
"Rabinovich, Alexander",22,28,50,,
"Moiseev, Viktor",26,24,50,,
"Juhnke, Juergen",29,21,50,,
"Teplitsky, Yan",24,26,50,,
"Hohler, Peter",22,28,50,,
"Nakhapetiane, Pogos",23,27,50,,
"Caprio, Guido",32,18,50,,
"Milchev, Nikolay",21,29,50,,
"Cornelis, Frans B.",24,26,50,,
"Roux Cabral, Luis",25,25,50,,
"Lugo, Blas",27,23,50,,
"Campomanes, Florencio",26,24,50,,
"Trmal, Jaroslav",26,24,50,,
"Yanchenko, Roman",25,25,50,,
"Galstian, Beniamin",25,25,50,,
"Castillo Bermudez, Manuel",25,25,50,,
"Allan, Denis",24,26,50,,
"Svoboda, Vaclav1",21,29,50,,
"Zaw, Win Lay",26,24,50,,
"Schories, Georg",27,23,50,,
"Ajay, Karthikeyan",21,29,50,,
"Lomaja, Teimuraz",26,24,50,,
"Leski, Marc",27,23,50,,
"Karpeshov, Oleg",28,22,50,,
"Friedman, Shmuel",23,27,50,,
"Bakhmatsky, Vladislav",23,27,50,,
"Perdomo, Leandro",21,29,50,,
"Thormann, Wolfgang",23,27,50,,
"Rossmann, Helmut",21,29,50,,
"Cuderman, Vinko",23,27,50,,
"Raud, Ilmar",24,26,50,,
"Kalantaryan, Norayr",19,31,50,,
"Begmuratov, Khumoyun",22,28,50,,
"Dzevlan, Miralem",22,28,50,,
"Wehmeier, Stefan",28,22,50,,
"Terry, Renato",15,35,50,,
"Lieb, Harald",25,25,50,,
"Ristic, Nebojsa M.",22,28,50,,
"Davie, Alexander Munroe",22,27,49,,
"Pohla, Harry",24,25,49,,
"Uritzky, Maxim",29,20,49,,
"Ruiz Sanchez, Orlen",26,23,49,,
"Suess, Alois",24,25,49,,
"Tsvetkov, Andrey",25,24,49,,
"Litmanowicz, Wladyslaw",27,22,49,,
"Kerkhoff, Leo J.",25,24,49,,
"Delander, Adolf",26,23,49,,
"Kvetny, Mark",24,25,49,,
"Klyuner, Vyacheslav",23,26,49,,
"Brumen, Dinko",26,23,49,,
"Gisbrecht, Ewgeni",21,28,49,,
"Panzalovic, Srdjan",25,24,49,,
"Neamtu, Serban-Constantin",26,23,49,,
"Ilic, Zoran S.",20,29,49,,
"Mardle, Denis Victor",26,23,49,,
"Raetsch, Heinz",23,26,49,,
"Wood, Gabriel",24,25,49,,
"Domsgen Hoelzlein, Christina",25,24,49,,
"Gentil, Luiz Jr",25,24,49,,
"Bokuchava, Alexander",22,27,49,,
"Canepa, Jose",26,23,49,,
"Bojkovic, Slobodan",26,23,49,,
"Petrienko, Vladimir",24,25,49,,
"Polajzer, Danilo",21,28,49,,
"Rosner, Jonas",21,28,49,,
"Muffang, Andre",23,26,49,,
"Whitaker, Norman Tweed",22,27,49,,
"Letzelter, Jean-Claude",21,28,49,,
"Grinev, Valeriy",25,24,49,,
"Mengarini, Ariel",27,22,49,,
"Seifert, Milan",21,28,49,,
"Witt, Laszlo",26,23,49,,
"Abramov, Lev",25,24,49,,
"Griffiths, Peter C.",24,25,49,,
"Nuernberg, Friedrich",24,25,49,,
"Berkovich, Dmitry",24,24,48,,
"Camilleri, Henry",27,21,48,,
"Wemmers, Xander",23,25,48,,
"Momo, Suren",24,24,48,,
"Rey Ardid, Ramon",25,23,48,,
"Novoselski, Zoran",23,25,48,,
"Kalme, Charles I.",23,25,48,,
"Khmelnitsky, Igor N.",24,24,48,,
"Schmakel, Sam A.",21,27,48,,
"Avshalumov, Alex",28,20,48,,
"Bae, Torstein",26,22,48,,
"Davidovic, Aleksandar",24,24,48,,
"Lukovic, Vladimir",25,23,48,,
"Sellman, Alexander",21,27,48,,
"Egger, Jorge",21,27,48,,
"Pang, Tao",20,28,48,,
"Dableo, Ronald",26,22,48,,
"Martinez Romero, Martin",22,26,48,,
"Ankerst, Marjan",24,24,48,,
"Nielsen, Hartvig",28,20,48,,
"Buza, Adrian",29,19,48,,
"Norman-Hansen, Holger",26,22,48,,
"Todorovic, Goran N.",22,26,48,,
"Siveri, Armando",27,21,48,,
"De Fotis, Gregory",24,24,48,,
"Ocampo, Raul",24,24,48,,
"Benitah, Yohan",23,25,48,,
"Subaric, Mladen",24,24,48,,
"Vujacic, Borivoje",23,25,48,,
"Wagner Michel, Annett",25,23,48,,
"Mullon, Jean-Baptiste",28,20,48,,
"Gluzman, Mikhail",29,19,48,,
"Mieles Palau, Daniel",21,27,48,,
"Malevinsky, Alexander A.",27,21,48,,
"Fronczek, Heinrich",24,24,48,,
"Pham, Minh Hoang",22,26,48,,
"Iruzubieta Villaluenga, JM",19,29,48,,
"Batsanin, Dmitry",26,22,48,,
"Lubienski, Tadeusz",26,22,48,,
"Gedevanishvili, Dmitry",24,24,48,,
"Breustedt, Werner",23,25,48,,
"Gelfer, Israel",25,23,48,,
"Burgalat, Francisco J.",28,19,47,,
"Shipman, Walter",22,25,47,,
"Basjuni, Sad Zaglul",25,22,47,,
"Veroci, Zsuzsa",29,18,47,,
"Wahltuch, Victor L.",23,24,47,,
"Klein, Ernst",24,23,47,,
"Klenburg, Mikhail",26,21,47,,
"Kahn, Manfred",21,26,47,,
"Carlier, Bruno",24,23,47,,
"Manninen, Marko",25,22,47,,
"Koskinen, Heikki",22,25,47,,
"Asfora, Eduardo",26,21,47,,
"Matkowski, Wiktor",27,20,47,,
"Nomin-Erdene, Davaademberel",22,25,47,,
"Kjeldsen, Jens",24,23,47,,
"Baretic, Dragoljub",23,24,47,,
"Randviir, Juri",25,22,47,,
"Feoktistov, Alexey A.",21,26,47,,
"Piket, Joop J.",25,22,47,,
"Sibashvili, Giorgi",21,26,47,,
"Fries-Nielsen, Niels Jorgen",23,24,47,,
"Lopez Silva, Hugo",25,22,47,,
"Bier, Max",24,23,47,,
"Hermlin, Aarne",23,24,47,,
"Gromer, Aristide",21,26,47,,
"Aramanovich, I.",22,25,47,,
"Slizhevsky, Alexander",22,25,47,,
"Avirovic, Djordje",25,22,47,,
"Javanbakht, Nima",19,28,47,,
"Rubio Aguado, Fernando",24,23,47,,
"Torre Repetto, Carlos",19,28,47,,
"Barnes, Thomas Wilson",20,27,47,,
"Dovzik, Juri",19,28,47,,
"Bahamonde, Antonio",23,24,47,,
"Sandrin, Albert",24,23,47,,
"Akash Pc, Iyer",22,25,47,,
"Karsa, Laszlo",23,24,47,,
"Joksic, Sinisa",17,30,47,,
"Van Foreest, Arnold E.",21,26,47,,
"Zhao, Chenxi",23,24,47,,
"Kleijn, Christov",28,19,47,,
"Xiao, Tong(QD)",24,23,47,,
"Lindblom, Per",18,29,47,,
"Mukhitdinov, Mamadzhan",24,23,47,,
"Berger, Steve",25,22,47,,
"Wynn, Zaw Htun",18,29,47,,
"Nepomnishay, Mikhail I.",22,25,47,,
"De Bruycker, Bernard",24,22,46,,
"Hybl, Jaroslav",23,23,46,,
"Gamarra Caceres, Carlos",26,20,46,,
"Arat, Ufuk Sezen",25,21,46,,
"Balogh, Bela",22,24,46,,
"Giffard, Nicolas",23,23,46,,
"Colon, Arturo",24,22,46,,
"Mantovani, Renzo",27,19,46,,
"Zaid, Leonid D.",23,23,46,,
"Grund, Holger",21,25,46,,
"Getz, Nicolai",22,24,46,,
"Oliwa, Marek",21,25,46,,
"Rivera, Alberto",23,23,46,,
"Backwinkel, Paul",21,25,46,,
"Pereira, Ruben",19,27,46,,
"Haug, Johannes",26,20,46,,
"Miesbauer, Jan",22,24,46,,
"Zemerov, Vladimir",23,23,46,,
"Kong, Xiangrui",21,25,46,,
"Dias, Paulo",20,26,46,,
"Rotstein, Jefim",23,23,46,,
"Machacek, Petr",24,22,46,,
"Tsagan, T.",23,23,46,,
"Seredenko, Vladimir",23,23,46,,
"Ellrich, Paul",21,25,46,,
"Hruby, Vincenz",25,21,46,,
"Prochownik, Franciszek",22,24,46,,
"Manea, Alexandru",23,23,46,,
"Leskovar, Mario",20,26,46,,
"Rohit, Gogineni",19,27,46,,
"Saborido Carne, Rafael",25,21,46,,
"Jensen, Allan",20,26,46,,
"Sagit, Rauan",21,25,46,,
"Zelinsky, Yuri",24,22,46,,
"Movahed, Sina",23,23,46,,
"Zhang, Ziji",24,22,46,,
"Halfdanarson, Jon",23,22,45,,
"Kuppe, Wilhelm",19,26,45,,
"Palmiotto, Fiorentino",25,20,45,,
"Lin, Yi",23,22,45,,
"Bernstein, David",23,22,45,,
"Stein, Georg",17,28,45,,
"Slaby, Jerzy",19,26,45,,
"Anapolsky, Sergey",21,24,45,,
"Lagha, Khelil",22,23,45,,
"Kiselev, Gennady",22,23,45,,
"Solmanis, Zigfrids",20,25,45,,
"Khader, Sami",25,20,45,,
"Mayet, Carl",24,21,45,,
"Etchegaray, Patrice",19,26,45,,
"Llorente Zaro, Alfonso",17,28,45,,
"Toshkov, Tihomir",21,24,45,,
"Ferguson, Mark",20,25,45,,
"Laveryd, Peter",17,28,45,,
"Kislov, Mikhail",21,24,45,,
"Illijin, Neboisa",17,28,45,,
"Popovics, Adam",22,23,45,,
"Trabattoni, Franco",23,22,45,,
"Limbos, Paul",24,21,45,,
"Maryasin, Boris",21,24,45,,
"Wang, Pin",22,23,45,,
"Hazenfuss, Wolfgang R.",20,25,45,,
"Bykova, Elisaveta I.",21,24,45,,
"Van den Berg, Adrianus MJ",24,21,45,,
"Halprin, Alexander",22,23,45,,
"Beltran Rueda, Santiago",17,28,45,,
"Gobet, Fernand",20,25,45,,
"Szekely, Mihaly",22,23,45,,
"Garrido Outon, Alex",23,22,45,,
"Hammar, Bengt",26,19,45,,
"Jelling, Erik",19,26,45,,
"Burstein, S.",20,25,45,,
"Schwarz, Michael",21,24,45,,
"Lamprecht, Frank",18,27,45,,
"Livshits, Gaby",20,25,45,,
"Wemmers, Carl",24,21,45,,
"Plischki, Sebastian",18,27,45,,
"Kirilov, Valentins",20,25,45,,
"Bilyap, Siracettin",19,26,45,,
"Eriksson, Johan",19,26,45,,
"Sliwinski, Henryk",23,22,45,,
"Mongredien, Augustus",21,24,45,,
"Stamenkovic, Zoran",18,27,45,,
"Nedeljkovic, Verica",23,21,44,,
"Roehrl, Karl",17,27,44,,
"Csiszar, Csaba",14,30,44,,
"Sinanovic, Muhamed",19,25,44,,
"Fernandez De La Vara, Arnaldo",20,24,44,,
"Fahnenschmidt, Gerhard",23,21,44,,
"Burehall, Arne",20,24,44,,
"Sacconi, Antonio",24,20,44,,
"Zenzera, Alexey",25,19,44,,
"Meribanov, Vitaly",25,19,44,,
"Padmini, Rout",26,18,44,,
"Sandalakis, Angelos",16,28,44,,
"Da Silva Rocha, Adhemar",22,22,44,,
"Nenarokov, Vladimir",21,23,44,,
"Bittencourt, Jorge",18,26,44,,
"Kustar, Sandor",21,23,44,,
"Zarkua, Davit",26,18,44,,
"Meleghegyi, Csaba",22,22,44,,
"Hearst, Eliot",20,24,44,,
"Franco Raymundo, Eduardo",23,21,44,,
"Lepeshkin, Vladimir",20,24,44,,
"Aparicio, Anibal",24,20,44,,
"Polihroniade, Elisabeta",22,22,44,,
"Fleck, Juergen",24,20,44,,
"Petrik, Karol",25,19,44,,
"Meszaros, Michal",20,24,44,,
"Babula, Milan",20,24,44,,
"Lashkin, Jegor",24,20,44,,
"Zaitsev, Vadim",21,23,44,,
"Paglilla, Carlos",22,22,44,,
"Bora, Safal",17,27,44,,
"Zubritskiy, Artyom",20,24,44,,
"Weichhold, Pawel",19,25,44,,
"Ivarsson, Johnny",24,20,44,,
"Xie, George Wendi",22,22,44,,
"Krivokapic, Marko",19,25,44,,
"Lematschko, Tatjana",22,22,44,,
"Sermier, Guillaume",23,21,44,,
"Gralka, Julian",19,25,44,,
"Gamboa, Nelson",20,24,44,,
"Guseinov, Aidyn",26,18,44,,
"Baltag, Iulian",20,24,44,,
"Granados Gomez, Manuel",22,22,44,,
"Kohler, Anton",20,24,44,,
"Hardaway, Brewington",21,23,44,,
"Hommeles, Theo",20,24,44,,
"Sutton, Richard John",22,22,44,,
"Shashin, Alexsander A.",19,24,43,,
"Rayner, Emmanuel",19,24,43,,
"Noradounghian, Georges",24,19,43,,
"Ghane, Shojaat",20,23,43,,
"Shagalovich, Abo I.",20,23,43,,
"Sejkora, Vlastimil",20,23,43,,
"Levy, Louis",21,22,43,,
"Xue, Haowen",22,21,43,,
"Modr, Bretislav",20,23,43,,
"Gulbrandsen, Arne Vinje",18,25,43,,
"Pesantes Carbajal, Carlos",21,22,43,,
"Kochetkov, German",20,23,43,,
"Lejlic, Samir",23,20,43,,
"Nevednichy, Boris M.",23,20,43,,
"Veltmander, Iogannes",17,26,43,,
"Vastrukhin, Oleg",20,23,43,,
"Soby, Frode",22,21,43,,
"Poetz, Florian",22,21,43,,
"Maccioni, Alejandro",21,22,43,,
"Hutters, Tomas",22,21,43,,
"Messa, Roberto",24,19,43,,
"Suarez Pousa, Diego",22,21,43,,
"Crosa, Martin",22,21,43,,
"Gershman, J.",20,23,43,,
"Castaneda, Georgui",19,24,43,,
"Suesman, Walter Bradford",21,22,43,,
"Thal, Olaf",19,24,43,,
"Bredewout, Henk",21,22,43,,
"Gat, Israel",18,25,43,,
"Londyn, Radek",24,19,43,,
"Sulik, Franciszek",21,22,43,,
"Delgado Ramos, Hector",20,23,43,,
"Palacios de la Prida, Ernesto",21,22,43,,
"Ivanov, Alexey2",20,23,43,,
"Vanczak, Tamas",17,26,43,,
"Toth, Vince",21,22,43,,
"Remlinger, Larry",19,24,43,,
"Schlosser, Michael",21,22,43,,
"Schelfhout, Willem",23,20,43,,
"Gunawan, Ruben",20,23,43,,
"Lindgren, Philip",22,21,43,,
"Nagy, Geza",27,16,43,,
"Billecard, Moritz",21,21,42,,
"Golmayo Zupide, Celso",21,21,42,,
"Margolin, Boris",18,24,42,,
"Ratner, Boris",23,19,42,,
"Izbinsky, Stefan",21,21,42,,
"Feustel, Bernd",21,21,42,,
"Lilov, Valeri",23,19,42,,
"Oskam, Gerard",25,17,42,,
"Sebestyen, B.",18,24,42,,
"Wehnert, Lutz",19,23,42,,
"Nozdrachev, Leonid",22,20,42,,
"Grooten, Herman",18,24,42,,
"Zhang, Ziyang",21,21,42,,
"Gygli, Fritz",21,21,42,,
"Macias Pino, Diego",20,22,42,,
"Tzidkiya, Yeshaayahu",21,21,42,,
"Ivkovic, Dusan",21,21,42,,
"Nuenchert, Eveline",23,19,42,,
"Svoboda, Svatopluk",16,26,42,,
"Perpinya Rofes, Lluis Maria",22,20,42,,
"Jensen, Erik B.",24,18,42,,
"Freeman, Michael J.",18,24,42,,
"Luik, Helmuth",19,23,42,,
"Machelett, Heiko",19,23,42,,
"Stumpers, Louis F.",20,22,42,,
"Grebionkin, Vladimir",22,20,42,,
"Riego Prieto, Victorio",22,20,42,,
"Prudnikova, Svetlana",21,21,42,,
"Badilles, Glicerio",19,23,42,,
"Kernan, Bernard",23,19,42,,
"Garces, Napoleon",17,25,42,,
"Schmidt, Bodo",18,24,42,,
"Scarella, Enrique Alejandro",20,22,42,,
"Gruber, Theodor",22,20,42,,
"Khavin, Abram Leonidovich",21,21,42,,
"Hansen, Victor Juul",20,22,42,,
"Hennig, Dirk",18,24,42,,
"Khodashenas, Mersad",21,21,42,,
"Hacker, Jonas",26,16,42,,
"Welling, Gerard",15,27,42,,
"Burchardt-Hofmann, Brigitte",17,25,42,,
"Moen, Ole Christian",22,20,42,,
"Soln, Primoz",24,18,42,,
"Kulzinski, Nikolaj",18,24,42,,
"Arnaudov, Petar",16,26,42,,
"Bodiroga, Predrag",17,25,42,,
"Rodriguez, Al",22,19,41,,
"Krzisnik, Zvonko",19,22,41,,
"Blejkmans, Dirk",20,21,41,,
"Turova, Irina",20,21,41,,
"Harmon-Vellotti, Luke",20,21,41,,
"Kremenietsky, Anatoly M.",21,20,41,,
"Moller, Baldur",24,17,41,,
"Lortkipanidze, Nodar",20,21,41,,
"Westman, Jan Erik",17,24,41,,
"Tairova, Elena",24,17,41,,
"Rodriguez, Jo",18,23,41,,
"Jakhin, Rashid",17,24,41,,
"Livshin, Iosif",19,22,41,,
"Lhagva, Jambaldoo",22,19,41,,
"Alvarado Diaz, Alejandro",20,21,41,,
"Roubalik, Jakub",19,22,41,,
"Mackenzie, Arthur John",17,24,41,,
"Hardicsay, Peter",22,19,41,,
"Engel, Jindrich",19,22,41,,
"Al Qudaimi, Basheer",21,20,41,,
"Serafimov, Tervel",21,20,41,,
"Pakhomov, Egor",18,23,41,,
"Handler, Lukas",19,22,41,,
"Martinez Martin, David",19,22,41,,
"Bilych, Olexiy",23,18,41,,
"Geller, Alexander G.",22,19,41,,
"Enevoldsen, Harald",19,22,41,,
"Nogues Acuna, Alejandro",21,20,41,,
"Gracs, Pal",21,20,41,,
"Szigeti, Miklos",21,20,41,,
"Gadjily, Raouf",20,21,41,,
"Diaz Perez, Michel Alejandro",22,19,41,,
"Treybal, Frantisek",19,22,41,,
"Kojima, Shinya",22,19,41,,
"Fontein, George Salto",20,21,41,,
"Zinkl, Adolf",21,20,41,,
"Chukaev, Egor",22,19,41,,
"Dejkalo, Stefan",17,24,41,,
"Stamenkovic, Dragan",16,25,41,,
"Klein, Manfred",19,22,41,,
"Baskin, Robert",18,23,41,,
"Pieterse, Gert",19,22,41,,
"Steinberg, Mikhail",20,21,41,,
"Hottes, Dieter",19,22,41,,
"Korsunsky, Rostislav R.",25,16,41,,
"Ivanco, Imrich",20,21,41,,
"Tong, Yuanming",19,22,41,,
"Ravikumar, Vaidyanathan",18,23,41,,
"Cobb, Charles A.",18,23,41,,
"Planas Garcia, Francisco",18,23,41,,
"Staudte, Hans-Hilmar",23,18,41,,
"Kotainy, Jens",22,19,41,,
"Sterner, Olof",19,22,41,,
"Nilsson, Allan",23,18,41,,
"Fischer, Johann Stefan",17,24,41,,
"Louma, Josef",18,22,40,,
"Perez Cascella, Julio",21,19,40,,
"Mah, Karl CC",19,21,40,,
"Girish, A. Koushnik",16,24,40,,
"Andersson, Bengt",17,23,40,,
"Kriventsov, Stanislav G.",20,20,40,,
"Espig, Thomas",19,21,40,,
"Branicki, Ignacy",20,20,40,,
"Gabrys, Zygmunt",20,20,40,,
"Touzane, Olivier",24,16,40,,
"Duppel, Matthias",25,15,40,,
"Black, Roy Turnbull",21,19,40,,
"Lorenz, Gerd",24,16,40,,
"Schmitz, Bernd",18,22,40,,
"Ciemniak, Robert",17,23,40,,
"Petkidis, Anthony",20,20,40,,
"Koshy, Varugeese",20,20,40,,
"Swanson, Stephen",20,20,40,,
"Fernandez Bravo, Ciro Angel",21,19,40,,
"Sinclair, Ian",18,22,40,,
"Ofstad, Per",17,23,40,,
"Pilnick, Carl",17,23,40,,
"Podhorzer, David",22,18,40,,
"Sibarevic, Milenko",20,20,40,,
"Marcussi, Bartolome J.",16,24,40,,
"Spyropoulos, Nikolaos",16,24,40,,
"Stanley, Charles Henry",19,21,40,,
"Gil Capape, Javier",19,21,40,,
"Igel, Fritz",22,18,40,,
"Ostos, Julio Eduardo",20,20,40,,
"Norman, George Marshall",21,19,40,,
"Lipski, Tadeusz",19,21,40,,
"Falkbeer, Ernst",20,20,40,,
"Tichy, Vladimir",20,20,40,,
"Slapikas, Vytautas",18,22,40,,
"Stefanov, Parik",20,20,40,,
"Butunoi, Alexandru-Victor",15,25,40,,
"Prokop, Frantisek",19,21,40,,
"Gregory, Bernhard",20,20,40,,
"Yepez, Trotzky",17,23,40,,
"Reiss, Tibor",23,17,40,,
"Tarve, Udo",19,21,40,,
"Galaviz Medina, Sion Radamantys",22,18,40,,
"Boguslawski, Oleg",24,16,40,,
"Porat, Shay",23,17,40,,
"Dmitriev, Igor",24,16,40,,
"Lebedev, Sergey F.",19,21,40,,
"Quinn, Mark",18,22,40,,
"Grib, Roman",16,23,39,,
"Gesos, Pavlos",20,19,39,,
"Richter, Christian",16,23,39,,
"Romanenko, Vladimir",18,21,39,,
"Weissgerber, Gerhard",19,20,39,,
"Macles, Jacques",19,20,39,,
"Pollak, Georg",19,20,39,,
"Elstner, Rudolf",16,23,39,,
"Turner, Abe J.",18,21,39,,
"Blanco Ronquillo, Humberto L.",24,15,39,,
"Englund, Fritz",18,21,39,,
"Zolnierowicz, Krzysztof",21,18,39,,
"Ibrahimoglu, Ismet",18,21,39,,
"Batuev, Andrey Mikhailovich",21,18,39,,
"Svensson, Gert",17,22,39,,
"Ebralidze, Arkhil",16,23,39,,
"Becker, Marcel",17,22,39,,
"Vallin, Guillaume",13,26,39,,
"Janssen, Lieselotte",17,22,39,,
"Trost, Edvin",17,22,39,,
"Roa Alonso, Santiago",21,18,39,,
"Ciejka, Tadeusz",16,23,39,,
"Reissmann, Paul",19,20,39,,
"Norowitz, Yaacov",17,22,39,,
"Condie, Mark L.",22,17,39,,
"Atanasov, Anthony",22,17,39,,
"Wang, Lei",18,21,39,,
"Rodriguez, Jose ES",17,22,39,,
"Razafindratsima, Timothe",16,23,39,,
"De Veauce, Louis",18,21,39,,
"Bozic, Milan",20,19,39,,
"Young, Angelo",21,18,39,,
"Salo, Toivo",17,22,39,,
"Boros, Sandor",18,21,39,,
"Hajnal, Zoltan",23,16,39,,
"Alzate, Javier",20,19,39,,
"Dashko, Andrey",20,19,39,,
"Doerner, Charles",21,18,39,,
"Vaisman, Alexander N.",22,17,39,,
"Marcus, Joost",20,19,39,,
"Hofmann, Vilem",19,20,39,,
"Merenyi, Lajos",20,19,39,,
"Cobb, James",20,19,39,,
"Nedela, Vlastimil",20,19,39,,
"Yu, Lie",12,27,39,,
"Shoosmith, Hector W.",19,20,39,,
"Taleb, Moussa",22,17,39,,
"Cummings, David H.",20,19,39,,
"Burille, Constant Ferdinand",21,18,39,,
"Kollberg, Lothar",20,18,38,,
"Vasilchuk, Yury",17,21,38,,
"Sagar, Shah",19,19,38,,
"Gonzalez, G.",20,18,38,,
"Amartuvshin, Ganzorig",20,18,38,,
"Despotovic, Momcilo",19,19,38,,
"Hay, Trevor",14,24,38,,
"Lebedev, Boris",20,18,38,,
"Kevitz, Alexander",19,19,38,,
"Allahverdiyev, Anar",19,19,38,,
"Watzka, Horst",18,20,38,,
"Prelovszky, Laszlo",19,19,38,,
"Gniot, Tadeusz",20,18,38,,
"Lomako, Pavel",18,20,38,,
"Lambert, Hans",17,21,38,,
"Tepper, Marcel",18,20,38,,
"Morrison, Graham",17,21,38,,
"Vega Holm, Fernando",18,20,38,,
"Bets, Anatolij",20,18,38,,
"Vlagsma, Chris",16,22,38,,
"Kvaloy, Aksel Bu",17,21,38,,
"Lloyd, Kenneth W.",18,20,38,,
"Nicolai, Werner",20,18,38,,
"Shkapenko, Pavel",18,20,38,,
"Jacob, Franz",19,19,38,,
"Carow, Johannes",20,18,38,,
"Chuprov, A.",17,21,38,,
"Mukhin, Evgeny B.",17,21,38,,
"Hilton, CG",19,19,38,,
"Bures, Jaroslav",17,21,38,,
"Rodriguez Cordoba, Jesus R.",19,19,38,,
"Sirkia, Mauri O.",22,16,38,,
"De Gleria, Francesco",20,18,38,,
"Bauer, Johann Hermann",19,19,38,,
"Kaminski, Uwe",19,19,38,,
"Majorovas, Vitalijus",22,16,38,,
"Luckans, Arnolds",16,22,38,,
"Czaya, Richard",19,19,38,,
"Keller, Hans",19,19,38,,
"Straka, V.",16,22,38,,
"Shvedchikov, Anatoli I.",15,23,38,,
"Almeida Saenz, Alfonso",18,20,38,,
"Holas, Josef",17,21,38,,
"Podolsky, Horst",21,17,38,,
"Bruentrup, Dieter",21,17,38,,
"Krivec, Slavko",18,20,38,,
"Pedersen, Svend",18,20,38,,
"Saint Amant, Pierre C.",20,18,38,,
"Golovin, Leonid",17,21,38,,
"Valenti, Giuseppe",17,21,38,,
"Orso, Miklos",18,20,38,,
"Mehmeti, Dritan",20,18,38,,
"Brien, Robert Barnett",20,18,38,,
"Donguines, Fernie",18,20,38,,
"Repkova, Eva",20,18,38,,
"Thiellement, Andre",18,20,38,,
"Bulat, Ante",19,19,38,,
"Ivanov, Timur",19,19,38,,
"Laszlo, Csaba",18,19,37,,
"Fuss, Immo",17,20,37,,
"Sanchez Alvarez, Roberto Carlos",17,20,37,,
"Kuebart, Erich",19,18,37,,
"Lange, Max",19,18,37,,
"Weiner, Milan",17,20,37,,
"Afek, Yochanan",17,20,37,,
"Jackova, Jana",20,17,37,,
"Gonsior, Evzen",18,19,37,,
"Fredriksson, Leif",18,19,37,,
"Martens, Rolf",16,21,37,,
"Foygel, Igor",17,20,37,,
"Roseneck, Jonas",17,20,37,,
"Wostin, Rik Hendrik",20,17,37,,
"Fox, Albert Whiting",16,21,37,,
"Soto Hernandez, Henry",18,19,37,,
"Erdelyi, Stefan",19,18,37,,
"Havansi, Erkki ET",19,18,37,,
"Kindij, Igor",20,17,37,,
"Donovan, Jeremiah",20,17,37,,
"Klarenbeek, Hans",16,21,37,,
"Buchal, Stephan",20,17,37,,
"Ivanka-Budinsky, Maria",23,14,37,,
"Di Benedetto, Edoardo",15,22,37,,
"Ungnad, Rainer",20,17,37,,
"Galia, Karl",17,20,37,,
"Androvitzky, Karoly",18,19,37,,
"Gabdrakhmanov, Rafail",20,17,37,,
"Kalinin, Alexander",18,19,37,,
"Degenhardt, Norbert",17,20,37,,
"Reed Valenzuela, Enrique",19,18,37,,
"Nobrega, Adaucto Wanderley",15,22,37,,
"Lipiniks, Leonardo",17,20,37,,
"Luna, Julio",17,20,37,,
"German, Gustavo",22,15,37,,
"Hinne, Jobst",17,20,37,,
"Bogdanov, Egor",15,22,37,,
"Sotnikov, Igor",16,21,37,,
"Mitkov, Marjan",18,19,37,,
"Syre, Christian",18,19,37,,
"Horne, Dennis Morton",20,17,37,,
"Sitanggang, Salor",19,18,37,,
"Kopetzky, Karl",17,20,37,,
"Kavutskiy, Konstantin",17,20,37,,
"Saadi, Julio",18,19,37,,
"Ljubisavljevic, Zivojin Z.",22,15,37,,
"Poley, Vladimir",18,19,37,,
"Bokor, Istvan",19,18,37,,
"Heinzel, Olaf",13,24,37,,
"Nemeth, Francisc",16,21,37,,
"Beretta, H.",17,20,37,,
"Vidarte Morales, Arturo",21,16,37,,
"Osmanagic, Dusan",17,20,37,,
"Fallone, Michael",17,20,37,,
"Rind, Bruce",19,17,36,,
"Filipenko, Alexander V.",16,20,36,,
"Daniliuk, Sergey",20,16,36,,
"Mross, Paul",18,18,36,,
"Casafus, Ruben",17,19,36,,
"Luecke, Norbert",18,18,36,,
"Yepez, Osvaldo",21,15,36,,
"Dreyer, Kurt",13,23,36,,
"Benkner, Otto",21,15,36,,
"Winz, Victor",16,20,36,,
"Barda, Yngvar",19,17,36,,
"Lees, David",16,20,36,,
"Chu, Wei Chao",20,16,36,,
"Nasanjargal, Urtnasan",16,20,36,,
"Parr, David",17,19,36,,
"Nielsen, Julius",14,22,36,,
"Magai, Vladimir",21,15,36,,
"Shlyakhtenko, Robert",21,15,36,,
"Recalde, Eleuterio",22,14,36,,
"Mashian, Yaacov",15,21,36,,
"Eolian, Levon S.",19,17,36,,
"Balogh, Tomas",16,20,36,,
"Brasket, Curt J.",18,18,36,,
"Wegner, Hannu",16,20,36,,
"Lambert, Glenn EJ",17,19,36,,
"Di Nicolantonio, Lucas",19,17,36,,
"Mahdy, Khaled",16,20,36,,
"Sredojevic, Ivan",20,16,36,,
"Bancod, Ronald",18,18,36,,
"Malikentzos, Sotirios",20,16,36,,
"Pham, Tran Gia Phuc",18,18,36,,
"Popov, Vladimir",18,18,36,,
"Heyken, Enno",15,21,36,,
"Kozlov, V.",17,19,36,,
"Salinnikov, Denis Y.",16,20,36,,
"Berezovsky, Igor",21,15,36,,
"Iakymov, Volodymyr",20,16,36,,
"Kaliksteyn, Alexander",18,18,36,,
"Zaitsev, Mikhail",14,22,36,,
"Boric, Muhamed",12,24,36,,
"Fletzer, Gino",19,17,36,,
"Joyner, Lionel",17,19,36,,
"Lee, Graham D.",16,20,36,,
"Cording, Harm",14,22,36,,
"Pcola, Pavol",13,23,36,,
"Stribuk, Artiom",17,18,35,,
"Savina, Anastasia",18,17,35,,
"Vujosevic, Vladimir",14,21,35,,
"Sergeev, Veniamin",17,18,35,,
"Beil, Zdenek",18,17,35,,
"Kadrev, Zdravko",16,19,35,,
"Muchnik, Khanan Lvovich",18,17,35,,
"Di Camillo, Attilio",16,19,35,,
"Bueno Perez, Lazaro Antonio",20,15,35,,
"Pioch, Zygmunt",18,17,35,,
"Sehner, Norbert",17,18,35,,
"Gusev, Nikolay Nikolaevich",12,23,35,,
"Grabinsky, Aaron",19,16,35,,
"Boudre, Jean-Pierre",18,17,35,,
"Needleman, Gaston",18,17,35,,
"Small, Vernon A.",21,14,35,,
"Bernat, Miguel",19,16,35,,
"Saverymuttu, Seth",15,20,35,,
"Mandl, Robert",19,16,35,,
"Seitaj, Ilir",16,19,35,,
"Schwan, Wilhelm",18,17,35,,
"Roux Cabral, Fausto",21,14,35,,
"Santos, Carlos Pereira dos",17,18,35,,
"Staldi, Cherubino",17,18,35,,
"Mohammad Minhaz, Uddin",17,18,35,,
"Wach, Markus",17,18,35,,
"Milosevic, Goran",16,19,35,,
"Kourkounakis, Ilias",11,24,35,,
"Gruchacz, Robert",15,20,35,,
"Lorson, Gerhard",15,20,35,,
"Asgeirsson, Asmundur",17,18,35,,
"Nezar, Mustapha",15,20,35,,
"Bidev, Pavle",18,17,35,,
"Carmaciu, Lucian-Catalin",19,16,35,,
"Steinbaum, Fernando",15,20,35,,
"Klein, Juan Carlos",19,16,35,,
"Demkovich, Anatoliy",17,18,35,,
"Radojcic, Miroslav",16,19,35,,
"Figura, Atila Gajo",16,19,35,,
"Danilov, Vladimir",16,19,35,,
"Beinoras, Mindaugas",15,20,35,,
"Kalashian, Loris",15,20,35,,
"Suarez Real, Alberto",20,15,35,,
"Akselrod, Vladislav",17,18,35,,
"Betak, Miroslav",17,18,35,,
"Abarca Gonzalez, Nicolas",17,18,35,,
"Harsh, Suresh",19,16,35,,
"Colbow, Collin",14,21,35,,
"Molnar, Imre",19,16,35,,
"Sveshnikov, Vladimir",16,19,35,,
"Nielsen, Palle Moeller",20,15,35,,
"Akopian, Gagnik E.",19,16,35,,
"Ban, Jeno",19,16,35,,
"Newman, RH",19,16,35,,
"Stolberg, Mark Moiseevich",18,17,35,,
"Keller, Rudolf",19,16,35,,
"Materia, Marco",18,17,35,,
"Djantar, Djordje",15,20,35,,
"Kovalev, Denis",16,19,35,,
"Shashin, Boris S.",16,19,35,,
"Piankov, Evgenij",17,18,35,,
"Solin, Ilmari",17,18,35,,
"Bensadon, Rafael",17,18,35,,
"Tella, Jussi",19,16,35,,
"Kozak, Antoni",15,20,35,,
"Vukovic, Milosav",17,18,35,,
"Lovas, Gyula",16,19,35,,
"Dragojlovic, Andjelko",17,17,34,,
"Nedilko, Vasily",12,22,34,,
"Mamedov, Edgar",14,20,34,,
"Kravtsov, Sergey",17,17,34,,
"Moor, Roger",15,19,34,,
"Kiss, Attila",16,18,34,,
"Tokhirjonova, Gulrukhbegim",16,18,34,,
"Kroeze, Frank",12,22,34,,
"Ibrahimli, Murad",18,16,34,,
"Garcia, Wilfredo",18,16,34,,
"Martins, David Pires Tavares",16,18,34,,
"Gurieli, Nino",14,20,34,,
"Blake, Joseph Henry",21,13,34,,
"Sahl, Bjarke",17,17,34,,
"Vecsey, Zoltan",17,17,34,,
"Jones, Iolo C.",16,18,34,,
"Canobra, Juvenal",19,15,34,,
"Burri, Quentin",14,20,34,,
"Stekel Grunberg, Moises",15,19,34,,
"McPhillips, Joseph",15,19,34,,
"Schorr, Leon",12,22,34,,
"Lagowski, Patryk",20,14,34,,
"Aguettaz, Maxime",14,20,34,,
"Utemov, Vladimir",17,17,34,,
"Plenkovic, Zdenko",13,21,34,,
"Dimc, Dragutin",17,17,34,,
"Krupenski, Juri",18,16,34,,
"Bordonada, Glenn",20,14,34,,
"De las Heras, Juan Carlos",18,16,34,,
"Wallace, Albert Edward",17,17,34,,
"Yudovich, Mikhail Jr",18,16,34,,
"Trimborn, Cornelius",17,17,34,,
"Wang, Yaoyao",16,18,34,,
"Heintze, Marion",17,17,34,,
"Babiy, Anatoly",20,14,34,,
"Neat, Kenneth P.",17,17,34,,
"Anwesh, Upadhyaya",17,17,34,,
"Ekstrom, Folke",17,17,34,,
"Martinovici, Ilia",19,15,34,,
"Goldenberg, Richard",16,18,34,,
"Bazakutsa, Svyatoslav",16,18,34,,
"Lisenko, Alexander V.",16,18,34,,
"Suarez, JM",15,19,34,,
"Fleissig, Bernhard",22,12,34,,
"Vidyarthi, Vyom",17,17,34,,
"Posthuma, Joshua",13,21,34,,
"Fomichenko, Eduard",16,18,34,,
"Kieseritzky, Lionel",15,19,34,,
"Rojahn, Ernst",17,17,34,,
"Berezhnoi, Viktor",18,16,34,,
"Stein, Alan R.",15,19,34,,
"Bruedigam, Martin",14,20,34,,
"Senador, Emmanuel",19,15,34,,
"Aizenberg, Benny",14,20,34,,
"Khanov, Kurban",16,18,34,,
"Strobel, Ferdinand",17,17,34,,
"Mannheimer, Nathan",16,18,34,,
"Zimmermann, Otto",14,20,34,,
"Kundin, Alexander",16,18,34,,
"Alvarez Marquez, Johann Carlos",14,20,34,,
"Dimitrov, Pavel",18,16,34,,
"Magnusson, Olafur",19,15,34,,
"Slepoy, Iosif",18,16,34,,
"Factor, Samuel D.",17,17,34,,
"Sapar, Emelbek",16,18,34,,
"Graf, Juergen",14,19,33,,
"Garma, Chito",15,18,33,,
"Klovsky, Rafail",16,17,33,,
"Hradeczky, Tamas",16,17,33,,
"Bruemmer, Ullrich",17,16,33,,
"Lakdawala, Cyrus",17,16,33,,
"Shaposhnikov, Yury Nikolaevich",13,20,33,,
"Yankovsky, Roman",16,17,33,,
"Shen, Victor C.",16,17,33,,
"Dufresne, Jean",18,15,33,,
"Dubin, Jorge",16,17,33,,
"Iglesias, Alfredo",19,14,33,,
"Bogdanov, Valentin",16,17,33,,
"Rakhmangulov, Andrei",14,19,33,,
"Watson, Charles Gilbert",16,17,33,,
"Herrmann, Ludwig",19,14,33,,
"Platzack, Sven",17,16,33,,
"Van Doesburgh, Gerrit",15,18,33,,
"Zubarev, Nikolay",16,17,33,,
"Smirnov, Valerij",16,17,33,,
"Kaminsky, Oleg M.",12,21,33,,
"Quizon, Daniel",16,17,33,,
"Weil, Wolfgang",15,18,33,,
"Miana, Elias T.",15,18,33,,
"Halasz, Tamas",18,15,33,,
"Pilaj, Herwig",16,17,33,,
"Hernandez Marquez, Jose de Jesus",16,17,33,,
"Boehlig, Heinz",19,14,33,,
"Ajrapetian, Gevorg",14,19,33,,
"Perecz, Laszlo",16,17,33,,
"Arancibia Guzman, Eduardo",16,17,33,,
"Wallace, John Paul",17,16,33,,
"Catozzi, Henry",16,17,33,,
"Von Hennig, Heinrich",15,18,33,,
"De Groot, Adriaan",18,15,33,,
"Sinkovics, Peter",18,15,33,,
"Lipnowski, Irwin",18,15,33,,
"Porges, Moritz",17,16,33,,
"Carrasco Martinez, Juan M.",14,19,33,,
"Asfora, Marco Antonio H.",11,22,33,,
"Sorensen, Ernst",15,18,33,,
"Schmitt, Ludwig",14,19,33,,
"Feustel, Petra",22,11,33,,
"Von Bahr, Oskar",17,16,33,,
"Korsunsky, Yuri",15,18,33,,
"Hodakowsky, Georg",17,16,33,,
"Ristoja, Thomas W.",15,18,33,,
"Vlasak, Lukas",17,16,33,,
"Arutiunov, Albert",12,21,33,,
"Antonov, Vladimir",17,16,33,,
"Szapiel, Henryk",16,17,33,,
"Brat, Vaclav",19,14,33,,
"Vovsha, Eli",14,19,33,,
"Odendahl, Steven M.",19,14,33,,
"Bang, Erik",14,19,33,,
"Rachels, Stuart",16,17,33,,
"Umetsubo, Cesar Hidemitsu",16,17,33,,
"Rohith, Krishna S.",15,18,33,,
"Rajesh, Vav",15,18,33,,
"Audi, Ameya",18,15,33,,
"Korning, Peter",16,17,33,,
"Ilievski, Borce",18,15,33,,
"Kutirov, Rolando",15,18,33,,
"Harper, Bruce",21,12,33,,
"Oechslein, Rainer",14,19,33,,
"Contedini, Ennio",18,15,33,,
"Orendy, Emil",16,17,33,,
"Bernotas, Arturs",19,14,33,,
"Calneggia, Raul",17,16,33,,
"Kushagra, Mohan",18,15,33,,
"Valkesalmi, Kimmo",17,16,33,,
"Endzelins, Lucius",15,18,33,,
"Gunnarsson, Arnar",15,18,33,,
"Bodek, Michael H.",16,17,33,,
"Rubinstein, Jose",15,18,33,,
"Smiltiner, Shlomo",17,16,33,,
"Borja, Meliton",15,18,33,,
"Diaz, Salvador",21,12,33,,
"Juarez Flores, Carlos A.",18,15,33,,
"Starosek, Konstantin",12,21,33,,
"Kapu, Jeno",16,17,33,,
"Lichtenstein, Bernhard",17,16,33,,
"Bjarnason, Saevar",13,20,33,,
"Britton, Richard L.",21,12,33,,
"Marotti, Davide",16,17,33,,
"Gasimov, Rahim",19,14,33,,
"Alekseev, Vadim",15,18,33,,
"Rusanov, Michail",15,17,32,,
"Maerevoet, Sim",20,12,32,,
"Bigaliev, Renat",16,16,32,,
"Reprintsev, Alexander",19,13,32,,
"Travnicek, Peter",18,14,32,,
"Chikovani, Iuri",11,21,32,,
"Garcia Orus, Francisco",13,19,32,,
"Seliverstov, Vladimir",18,14,32,,
"Kalkstein, Rodolfo",21,11,32,,
"Lalev, Dimitar",13,19,32,,
"Giam, Choo Kwee",16,16,32,,
"Kernazhitsky, Leonid",16,16,32,,
"Ravisekhar, Raja",15,17,32,,
"Van de Mortel, Jan",19,13,32,,
"Berebora, Ferenc",15,17,32,,
"Belmonte Schwarzbaum, Juan",13,19,32,,
"Denman, Brian",17,15,32,,
"Malcanek, Oldrich",12,20,32,,
"Fridjonsson, Julius",22,10,32,,
"Ranola, Yves",15,17,32,,
"Zylka, Stanislaw",12,20,32,,
"Baumgartner, Heinz",16,16,32,,
"Bakos, S.",13,19,32,,
"Luczynowicz, Waclaw",16,16,32,,
"Duin, Laurens",16,16,32,,
"Vatnikov, Josif E.",12,20,32,,
"Barseghyan, Armen Ar",16,16,32,,
"Broekmeulen, Jasper",18,14,32,,
"Gojak, Ilija",15,17,32,,
"Barnes, Craig N.",15,17,32,,
"Khamatgaleev, Alexej",14,18,32,,
"Luce, Sebastien",16,16,32,,
"Brochet, Philippe",14,18,32,,
"Fyllingen, Roy Harald",14,18,32,,
"Pasman, Michael",14,18,32,,
"Guramishvili, Sopiko",15,17,32,,
"Askarov, Bakhtiyar",11,21,32,,
"Abasheev, Denis",13,19,32,,
"Kaiev, Lev Alexeevich",15,17,32,,
"Thomas, Richard Huw",21,11,32,,
"Zemgalis, Elmars",16,16,32,,
"Beggi, Pierluigi",18,14,32,,
"Trajkovic, Mihajlo",14,18,32,,
"Schmidek, Emil",13,19,32,,
"Ervin, Roy C.",17,15,32,,
"Harmonist, Max",16,16,32,,
"De Winter, Arthur",13,19,32,,
"Jimenez Rojas, Hector",20,12,32,,
"Kononenko, Tatiana",16,16,32,,
"Moberg, Karl Johan",19,13,32,,
"Bergqvist, Nils",15,17,32,,
"Lioe, Dede",18,14,32,,
"Blagojevic, Katarina",17,15,32,,
"Yoffie, Marc",22,10,32,,
"Leow, Leslie M.",15,17,32,,
"Moksh, Amit Doshi",18,14,32,,
"Sargsyan, Anna M.",15,17,32,,
"Ali, Muhammad Lutfi",14,18,32,,
"Carballo, F1",18,14,32,,
"Richter, Wolfgang",13,18,31,,
"Ahman, Ernst",15,16,31,,
"Carleton, John J.",16,15,31,,
"Sozin, Veniamin",15,16,31,,
"Kane, George Francis",14,17,31,,
"Schurade, Matthias",14,17,31,,
"Rosenkrantz, Karl W.",15,16,31,,
"Tan, Matthew",12,19,31,,
"Peng, Hongchi",16,15,31,,
"Fabian, Henryk",13,18,31,,
"Martinez, Carlos Alejandro",16,15,31,,
"Bangiev, Alexander",17,14,31,,
"Jovanic, R.",13,18,31,,
"Varadi, Viktor",10,21,31,,
"Vark, Kalju",16,15,31,,
"Sertic, Rudolf",16,15,31,,
"Atakhan, Abtin",14,17,31,,
"Mahia, Gustavo",17,14,31,,
"Deacon, Frederic",16,15,31,,
"Hora, Vratislav",18,13,31,,
"Bernstein, Yaacov",17,14,31,,
"Edelman, Daniel",16,15,31,,
"Laird, Craig",13,18,31,,
"Kurochkin, Victor",17,14,31,,
"Walter, Stefan1",13,18,31,,
"Grigoriev, Nikolai D.",18,13,31,,
"Brandts, Paul",16,15,31,,
"Tschepurnoff, Anatol A.",16,15,31,,
"Vasquez, Julio E.",16,15,31,,
"Neumann, Augustin",14,17,31,,
"Araiza Munoz, Jose Joaquin",17,14,31,,
"Damjanovic, Vladimir",11,20,31,,
"Nadj Hedjesi, Balind",14,17,31,,
"Bellin, Jana M.",16,15,31,,
"Papapostolou, Christos",18,13,31,,
"Nowarra, Waltraud",16,15,31,,
"Engert, Immo",16,15,31,,
"Mazzoleni, Julio",14,17,31,,
"Duer, Arne",15,16,31,,
"Molenda, Marcin",12,19,31,,
"Danov, Kiril",16,15,31,,
"Hammer, Peter",12,19,31,,
"Pasman, Marks",16,15,31,,
"Egorov, Evgeny",15,16,31,,
"Ayush, Sharma",13,18,31,,
"Knezevic, Bojan",16,15,31,,
"Geissert, Eberhard",16,15,31,,
"Ogloblin, Nikolay",18,13,31,,
"Bobekov, Radko",15,16,31,,
"Keller-Hermann, Edith",16,15,31,,
"Rocas, Orlando",15,16,31,,
"Markovic, Mihajlo",17,14,31,,
"Ginting, Nasib",16,15,31,,
"Kostjoerin, Anatole",17,14,31,,
"Palachev, Petr",14,17,31,,
"Botvinnik, Ilia",14,17,31,,
"Rubinstein, Simon",13,18,31,,
"Olsson, Anders",17,14,31,,
"Pichler, Juergen",9,22,31,,
"Morrison, John Stuart",17,14,31,,
"Hansen, Mads3",12,19,31,,
"Baturinsky, Victor Davidovich",16,15,31,,
"Krnan, Tomas",18,13,31,,
"Leban, Slavko",14,17,31,,
"Rensch, Daniel",18,13,31,,
"Ballmann, Martin",10,21,31,,
"Abdulov, Orkhan",11,19,30,,
"Ramirez, R.",14,16,30,,
"Kiolbasa, Oliwia",16,14,30,,
"Pfeil, Hartmut",13,17,30,,
"Myhre, Erling",14,16,30,,
"Elistratov, Semen",15,15,30,,
"Lushenkov, Mikhail M.",16,14,30,,
"Markus, Marcel",18,12,30,,
"Fox, Maurice",13,17,30,,
"Borghi, Humberto",15,15,30,,
"Thibaut, Georges Pierre",17,13,30,,
"Sahlmann, Walter",19,11,30,,
"Sichinava, Roman",15,15,30,,
"Torfason, Jon",11,19,30,,
"Findlay, David John",14,16,30,,
"Heral, Josef",15,15,30,,
"Blaszczak, Czeslaw",12,18,30,,
"Kwilecki, Andrzej",16,14,30,,
"Tennenwurzel, Edward",13,17,30,,
"Koshnitsky, Gregory Simon",14,16,30,,
"Kohl, Andreas",16,14,30,,
"Eales, Richard G.",15,15,30,,
"Green, Matthew",13,17,30,,
"Uskov, Artem",15,15,30,,
"Del Pozo, Nestor",16,14,30,,
"Sapre, Ramchandra",14,16,30,,
"Savitsky, Leonid",16,14,30,,
"Rosenberg, Arie",14,16,30,,
"Vyslouzil, Antonin",15,15,30,,
"Bastian, Herbert",12,18,30,,
"Baratz, Abraham",15,15,30,,
"Perdomo, Carlos Andres",15,15,30,,
"Zeltsan, Joseph",15,15,30,,
"Leyva Proenza, Ricardo",14,16,30,,
"Chen, Ryo",14,16,30,,
"Sapunov, Evgeny",16,14,30,,
"Stark, Lars",14,16,30,,
"Sorokin, Nikolay T.",15,15,30,,
"Von Jaenisch, Carl Friedrich",15,15,30,,
"Meissner, Bernd",16,14,30,,
"Asanov, Bolat",12,18,30,,
"Leiva, Giuseppe",13,17,30,,
"Large, Peter G.",17,13,30,,
"Kojder, Konrad",15,15,30,,
"Bade, Heidrun",18,12,30,,
"Morcken, Otto B.",15,15,30,,
"Chevaldonnet, Francois",15,15,30,,
"Toth, Andras",17,13,30,,
"Golovko, Nikolay Grigorievic",13,17,30,,
"Zdanovs, Igors",16,14,30,,
"Law, Andrew P.",15,15,30,,
"Borowski, Natan",11,19,30,,
"Lund, Espen",16,14,30,,
"Heidrich, Manfred",12,18,30,,
"Weinberger, Tibor",16,14,30,,
"Pereyra Arcija, Diego",12,18,30,,
"Stuart, Peter",11,19,30,,
"Loewe, Edward",15,15,30,,
"Fernandez, Fe",17,13,30,,
"Cao Armillas, Jesus",16,14,30,,
"Werle, Allan",12,18,30,,
"Bortnyk, Mykola",20,10,30,,
"Pershin, Denis",11,19,30,,
"McCormick, Edgar Thomas",9,21,30,,
"Gusev, Vladimir A.",13,17,30,,
"Evtifeev, Peter Artemievich",14,15,29,,
"Dearing, Eddie",16,13,29,,
"Panesar, Vedant",17,12,29,,
"Juarez, CF",16,13,29,,
"Perez Gonsalves, Eduardo",14,15,29,,
"Hage, Poul",17,12,29,,
"Yuneev, Alexey",13,16,29,,
"Green, Valentine",14,15,29,,
"Panov, Vladimir",14,15,29,,
Lim Kok Ann,13,16,29,,
"Sperber, Goran",16,13,29,,
"Besztercsenyi, Tibor",14,15,29,,
"Jovcic, Milan",13,16,29,,
"Dubois, Serafino",18,11,29,,
"Hase, Ricardo",14,15,29,,
"Voltschok, Alexander",14,15,29,,
"Araujo, Rodolfo",19,10,29,,
"Pantev, Veselin",11,18,29,,
"Viner, William S.",16,13,29,,
"Rubinow, Sol",15,14,29,,
"Vitoux, Colomban",14,15,29,,
"Annakov, Babakuli",13,16,29,,
"Matros, Alexander",13,16,29,,
"Mayer, Stepanka",13,16,29,,
"Bibiloni, Jorge Jaime",14,15,29,,
"Spencer, Edmund",15,14,29,,
"Michel, Walter",16,13,29,,
"Juksta, Karolis",14,15,29,,
"Savchenko, Viacheslav",10,19,29,,
"Bergsma, KM",13,16,29,,
"Bernabeu Lopez, Carlos Javier",15,14,29,,
"Taylor, Timothy",13,16,29,,
"Raceanu, Valentin",15,14,29,,
"Moeller, Jorgen",14,15,29,,
"Corzo y Principe, Juan",13,16,29,,
"Zaslavsky, Mikhail",15,14,29,,
"Soloviov, Sergei N.",11,18,29,,
"Masculo, Jose Soares",15,14,29,,
"Kahn, Victor",15,14,29,,
"Schilow, Wladimir",15,14,29,,
"Schubert, Frantisek",15,14,29,,
"Hooper, David",13,16,29,,
"Akhvlediani, Irakli",15,14,29,,
"Bademian Orchanian, Jose",15,14,29,,
"Martin, Julian",15,14,29,,
"Tadic, Stefan",18,11,29,,
"Haida, August Konrad",14,15,29,,
"Cifka, Stanislav",12,17,29,,
"Lawrence, Thomas F.",16,13,29,,
"Zimina, Olga",18,11,29,,
"O'Donnell, Tom",13,16,29,,
"Alvarez Perez, Jose",10,19,29,,
"Juhasz, Agoston",11,18,29,,
"Bazeev, German",15,14,29,,
"Crabbendam, Hans",15,14,29,,
"Rauch, Joseph Lyon",13,16,29,,
"Purevzhav, S.",8,21,29,,
"Rakay, Kvetoslav",12,17,29,,
"Paunovic, Tomislav",11,18,29,,
"Kobese, Watu",15,14,29,,
"Buskenstrom, Sven",12,17,29,,
"Leyva, Hector",14,14,28,,
"Galchenko, Matvey",14,14,28,,
"Seoev, Robert",16,12,28,,
"Gritsenko, Andrey",10,18,28,,
"Lund, Silas",17,11,28,,
"Garcia Cardenas, Pablo",16,12,28,,
"Pavlovic, Dejan S.",14,14,28,,
"Liu, Xiangyi",13,15,28,,
"Freitag, Manfred",12,16,28,,
"Olivier, Jean-Christophe",15,13,28,,
"Angos, Alexander",9,19,28,,
"Krumpacnik, Domen",16,12,28,,
"Bajec, Ivo",14,14,28,,
"Carlsson, Henrik",11,17,28,,
"Gonzalez Velez, Fermin",18,10,28,,
"Jorczik, Julian",14,14,28,,
"Lin, Ta",14,14,28,,
"Akhmetov, Ayan",14,14,28,,
"Herrmann, Hans",15,13,28,,
"Roensch, Ingrid",13,15,28,,
"Trickov, Vasil",12,16,28,,
"Nikitin, Yury M.",13,15,28,,
"Olenin, Nikolay",11,17,28,,
"Bjornsson, Tomas Sr",15,13,28,,
"Nedeljkovic, Aleksandar",15,13,28,,
"Medley, George",14,14,28,,
"Kalogeris, Ioannis",12,16,28,,
"Mascaro March, Pedro",14,14,28,,
"Aghayev, Miragha",14,14,28,,
"Primavera, Roberto",14,14,28,,
"Zuk, Robert D.",13,15,28,,
"Anderson, Bruce R.",13,15,28,,
"Gonzales, Eliseo",18,10,28,,
"Ramnath, Bhuvanesh.R",14,14,28,,
"Almgren, Sven",13,15,28,,
"Malmdin, Nils-Ake",13,15,28,,
"Valvo, Michael J.",15,13,28,,
"Percivaldi, Martin",12,16,28,,
"Holt, Eric",18,10,28,,
"Mileika, Janis",16,12,28,,
"Maliutin, Boris",16,12,28,,
"Aleshin, Oleg",14,14,28,,
"Martinez, JE",15,13,28,,
"Garcia Luque, Agustin",15,13,28,,
"Sosna, Jan",11,17,28,,
"Sonntag, Hans-Hubert",16,12,28,,
"Kurass, Iskir",14,14,28,,
"Anuj, Shrivatri",16,12,28,,
"Borisenko, Andrei",16,12,28,,
"Velandia, Norberto",15,13,28,,
"Pasko, Llambi",10,18,28,,
"Arfan, Aditya Bagus",9,19,28,,
"Boim, Inon",12,16,28,,
"Wells, Ian Duncan",14,14,28,,
"Chomet, Pascal",14,14,28,,
"Yandarbiev, Ruslan",13,15,28,,
"Wang, Li",14,14,28,,
"Garcia Roman, Daniel",14,14,28,,
"Link, Hugo E.",11,17,28,,
"Pena, Gustavo",12,16,28,,
"Pfreundt, Jakob",12,16,28,,
"Marthaler, Otto",14,14,28,,
"Anastasopoulos, Anastasios",7,21,28,,
"Basagic, Zlatko",16,12,28,,
"Poormosavi, Seyed Kian",16,12,28,,
"Somogyi, Istvan",14,14,28,,
"Fuentes, Juan Manuel",16,12,28,,
"Van Steenis, Hendrik Jan",14,14,28,,
"Purdy, John Spencer",11,17,28,,
"Shavtvaladze, Nikoloz",13,15,28,,
"Friedemann, Gunnar",12,16,28,,
"Dzhumagaliev, Yan",12,16,28,,
"Donev, Ivo",13,15,28,,
"Benitez, Otto",13,15,28,,
"Tyroler, Alexandru",15,13,28,,
"Oltra Caurin, Ramon",14,13,27,,
"Lachut, Jan",14,13,27,,
"Budowski, Gerardo",13,14,27,,
"Gilfer, Eggert",17,10,27,,
"Eugene, Floryan",15,12,27,,
"Vaz, Ethan",16,11,27,,
"Cesnauskas, Algimantas",16,11,27,,
"Kapetanovic, Armin",15,12,27,,
"Charlier, Raul",13,14,27,,
"Rostalski, Walter",14,13,27,,
"Auer, Franz",11,16,27,,
"Ben Artzi, Ido",14,13,27,,
"Volpert, Larisa",12,15,27,,
"Fritzinger, Dennis",12,15,27,,
"Babrikowski, Peter",15,12,27,,
"Ludolph, Jaan",10,17,27,,
"Goering, Carl Theodor",12,15,27,,
"Oren, Menachem",15,12,27,,
"Sadykov, Rustem",13,14,27,,
"Zander, Otto",13,14,27,,
"Brito, Luizmar J.",15,12,27,,
"Tran, Minh Thang",15,12,27,,
"Puscasiu, Octavian",16,11,27,,
"Ryan, John S.",13,14,27,,
"Leffmann, Karl",14,13,27,,
"Larrain Cadiz, Eugenio",12,15,27,,
"Mikadze, Zurab",14,13,27,,
"Diaz Murgada, Rider",15,12,27,,
"Kolesnik, Eduard",14,13,27,,
"Mosquera, Miguel",15,12,27,,
"Ofitserian, Boris",13,14,27,,
"Borsuk, Konstantin",14,13,27,,
"Hernandez Gonzalez, William",15,12,27,,
"Krasnov, Sergey",17,10,27,,
"Skuja, Roberts",15,12,27,,
"Brener, Ilja",13,14,27,,
"Zajic, Jiri",14,13,27,,
"Schwartzman, Aaron",13,14,27,,
"Molnar, Istvan",14,13,27,,
"Atanasov, Gospodin",12,15,27,,
"Degtiarev, Evgeny",16,11,27,,
"Castelli, Raul A.",14,13,27,,
"De Eccher, Stefano",12,15,27,,
"Kennedy, Hugh A.",14,13,27,,
"Studenetzky, Moises",11,16,27,,
"Kofman, Abram R.",14,13,27,,
"Ratolistka, Josef",12,15,27,,
"MacPhail, John",12,15,27,,
"Vekshenkov, Nikolai",12,15,27,,
"Gerstner, Wolfgang",14,13,27,,
"Jigjidsuren, Purev",13,14,27,,
"Lettieri, Giuseppe",13,14,27,,
"Michna, Marta",13,14,27,,
"Isupov, Vladimir",12,15,27,,
"Szalai, Kornel",12,15,27,,
"Khlian, Eduard",12,15,27,,
"Firman Syah, Farid",14,13,27,,
"Gibbs, Peter Campbell",15,12,27,,
"Gelbfuhs, Oscar",13,14,27,,
"Iljin, Timofey",12,15,27,,
"Lastovicka, Jiri",12,15,27,,
"Schroeder, Ruperto",11,16,27,,
"Saad, AI Sarsam",12,15,27,,
"Pizzi Possi, Tulio",15,12,27,,
"Kaila, Osmo Ilmari",17,10,27,,
"Witt, Rob",15,12,27,,
"Asanov, Timur",13,14,27,,
"Della Morte, German",14,13,27,,
"Czopor, Maciej",15,12,27,,
"Pavlov-Pianov, Nikolay",16,11,27,,
"Kolpakov, Mikhail",18,9,27,,
"Bykov, Valery N.",11,16,27,,
"Valeanu, Eduard-Andrei",11,16,27,,
"Pojedziniec, Wladyslaw",9,18,27,,
"Acosta, Alejandro",12,15,27,,
"Nurmi, Peter",12,15,27,,
"Orzech, Dominik",10,17,27,,
"Chavez, Romelio",13,14,27,,
"Eisenberg, Louis R.",13,14,27,,
"Simonovic, Aleksandar",15,12,27,,
"Blauert, Joerg",11,15,26,,
"Babev, Aleksandar",12,14,26,,
"Kizov, Atanas",13,13,26,,
"Mallahi, Amir",9,17,26,,
"Tikovsky, Augustin",12,14,26,,
"Liersch, Andreas",13,13,26,,
"Brach, Julius",12,14,26,,
"Freise, Helmut",13,13,26,,
"Andre, Wolfgang",12,14,26,,
"Hjorth, Sune",12,14,26,,
"Simonian, Tigran",13,13,26,,
"Wegemund, Otto",14,12,26,,
"Yabra, Freddy",9,17,26,,
"Zaruba, Antonin",11,15,26,,
"Arnold, Lothar",13,13,26,,
"Benoit, Michel",12,14,26,,
"Dolezal, Radoslav Jr",8,18,26,,
"Szablowski, Pawel",12,14,26,,
"Umansky, Mikhail",12,14,26,,
"Klaput, Edward",13,13,26,,
"Yelisieiev, Yevhenii",17,9,26,,
"Larusson, Gudmundur",12,14,26,,
"Szapiro, Gedali",13,13,26,,
"Helbach, Grigory",11,15,26,,
"Lanzani, Mario",11,15,26,,
"Zorigt, D.",11,15,26,,
"Evans, Larry D.",11,15,26,,
"Miyasaki, Yukio",14,12,26,,
"Shliperman, Igor",12,14,26,,
"Vantika, Agrawal",13,13,26,,
"Vul, Arkadi Eremeevich",9,17,26,,
"Steinmeyer, Robert",12,14,26,,
"Suarez, J.",14,12,26,,
"Belliard, Luis",18,8,26,,
"Nowacki, Marian",13,13,26,,
"Cassidy, Raymond",14,12,26,,
"Martinez, Rolly",12,14,26,,
"Prahov, Valentin",15,11,26,,
"Palit, Somak",12,14,26,,
"Vrabec, Milos",13,13,26,,
"Li, Ruofan",10,16,26,,
"Bartosek, Milan",14,12,26,,
"Milanovic, Slavisa",8,18,26,,
"Calapso, Remo",13,13,26,,
"Quezada, Y.",17,9,26,,
"Dobkin, Yosef",12,14,26,,
"Svenn, Matti",16,10,26,,
"Braun, Christian",15,11,26,,
"Belli, Mario",18,8,26,,
"Kertesz, Alfred",10,16,26,,
"Galburd, Yan",14,12,26,,
"Stambulian, Arsen",14,12,26,,
"Jonsson, Bjorgvin",12,14,26,,
"Ostrauskas, A.",13,13,26,,
"Dienavorian Lacherian, Manuel",10,16,26,,
"Nemec, Tadeus",15,11,26,,
"Johansson, Gunnar2",9,17,26,,
"Ramirez, Percy",13,13,26,,
"Youngworth, Perry",14,12,26,,
"Igriashvili, Zurab",15,11,26,,
"Khubukshanov, Erdem",12,14,26,,
"Buss, Ralph",12,14,26,,
"Jasnogrodsky, Nicolai",13,13,26,,
"Camara, Luciano",13,13,26,,
"Jacobson, Ernst",13,13,26,,
"Stein, Bernd",7,19,26,,
"Cheng, Bindi",9,17,26,,
"Roth, Peter",12,14,26,,
"Rohland, Michael K.",12,14,26,,
"Dornieden, Manfred",14,12,26,,
"Reca, Damian M.",13,13,26,,
"Ott, Roland",14,12,26,,
"Dos Santos, Ramiro",10,16,26,,
"Gumprich, Kurt",15,11,26,,
"Lachmann, Hans Georg",13,13,26,,
"Payrhuber, Klaus",14,12,26,,
"Rohl Montes, Juan Armando",15,10,25,,
"Dmitrenko, Viktor",15,10,25,,
"Acevedo Milan, Armando",13,12,25,,
"Kulkarni, Vikramaditya",12,13,25,,
"Fancsy, Imre",16,9,25,,
"Monostori, Lajos",13,12,25,,
"Saunders, Harold",13,12,25,,
"Arencibia, Juan Joel",11,14,25,,
"Yanev, Tihomir",12,13,25,,
"Christensen, Alfred",12,13,25,,
"Nilsson, Nils Specht",12,13,25,,
"Panda, Sambit",16,9,25,,
"Seuss, Oswald",13,12,25,,
"Bates, Richard A.",11,14,25,,
"Melamedoff, Manuel",10,15,25,,
"Pons, A.",13,12,25,,
"Laszlo, Deli",13,12,25,,
"Skacel, Jan",15,10,25,,
"Soors, Stef",11,14,25,,
"Carbone, Jose Maria",8,17,25,,
"Efanov, Nikolai",10,15,25,,
"Figueroa, Eduardo",12,13,25,,
"Rosen, Willy",11,14,25,,
"Malmgren, Sven-Goran",12,13,25,,
"Model, Abram Y.",12,13,25,,
"Kroone, Gerard",13,12,25,,
"Scheichel, Herbert",13,12,25,,
"Joie, Sebastien",11,14,25,,
"Meiners, WBH",8,17,25,,
"Kranki, Hans",13,12,25,,
"Kolnhofer, Josef",11,14,25,,
"Hagara, Eduard",11,14,25,,
"Patt Rubinstein, J.",14,11,25,,
"Skalik, Przemyslaw",16,9,25,,
"Weber, Bernd",12,13,25,,
"Klasups, Karlis",11,14,25,,
"Holtey, Guillermo",10,15,25,,
"Stark, Martin Charles",15,10,25,,
"Rohan, Ahuja",12,13,25,,
"Eigler, Ferenc",14,11,25,,
"Schulze, Ulrich",14,11,25,,
"Daniuszewski, Dawid",14,11,25,,
"Hjorth, Greg",12,13,25,,
"Heyns, Anthony",13,12,25,,
"Oim, Tonu",13,12,25,,
"Voit, Daria",10,15,25,,
"Purnama, Tirta Chandra",12,13,25,,
"Ostberg, Peter",10,15,25,,
"Garcia Vera, Oscar",12,13,25,,
"Van Riemsdijk, Dirk D.",12,13,25,,
"Vasilchenko, Oleg",16,9,25,,
"Yerhoff, Frank",12,13,25,,
"Jovanovic, Dusan D.",12,13,25,,
"Ingbrandt, Johan",13,12,25,,
"Konopleva, Natalia",10,15,25,,
"Dujkovic, Sinisa",13,12,25,,
"Kanov, Nikola",13,12,25,,
"Heemsoth, Hermann",10,15,25,,
"Klibor, Lutz",14,11,25,,
"Kovanova, Baira",8,17,25,,
"Keogh, Eamon",12,13,25,,
"Gatineau, Yovann",13,12,25,,
"Jacobsen, Egil",12,13,25,,
"Steinberg, Jose",13,12,25,,
"Dimitrijevic, Milorad",11,14,25,,
"Belavenets, Liudmila",10,15,25,,
"Dozsa, Paul",13,12,25,,
"Petrovskyi, Vadym",16,9,25,,
"Brown, Fred",12,13,25,,
"Lennox, C. Jonathan",14,11,25,,
"Cala, Ugo",16,9,25,,
"Malek, Daniel",12,13,25,,
"Zdebskaja, Natalia",13,12,25,,
"Mallee, Ralph",13,12,25,,
"Chaplinsky, Edgar",15,10,25,,
"Szell, Lajos",13,12,25,,
"Gouveia, Carlos Eduardo",10,14,24,,
"Vasconcellos, Fernando O.",10,14,24,,
"Elias Reyes, Jorge Roberto",9,15,24,,
"Degraeve, Remy",11,13,24,,
"Schroeder, Hannes",13,11,24,,
"Danov, Vladimir",11,13,24,,
"Schammo, J.",14,10,24,,
"Fleissig, Maximilian",12,12,24,,
"Hansen, Ja",11,13,24,,
"Carpinter, Anthony Lawrence",13,11,24,,
"Igambergenov, Alibek",14,10,24,,
"Lohmann, Heinrich",12,12,24,,
"Polzer, Hans",12,12,24,,
"Boden, Samuel Standige",13,11,24,,
"Heemskerk, Jan Hendrik",13,11,24,,
"Dubinsky, Alexander",12,12,24,,
"Sattarov, Bobir",10,14,24,,
"Stepovaia, Tatiana",14,10,24,,
"Novitzkij, Dmitrij",13,11,24,,
"Green, Barry N.",12,12,24,,
"Schmidt, Wolfgang",10,14,24,,
"Shalamberidze, Akaki",10,14,24,,
"Jukic, Branimir",10,14,24,,
"Bao, Qilin",10,14,24,,
"Eichhorn, Ernst",11,13,24,,
"Sully, David John",13,11,24,,
"Ljungdahl, John",13,11,24,,
"Pisk, Petr",15,9,24,,
"Koniushkov, Igor",13,11,24,,
"Longwitz, Andreas",12,12,24,,
"Tovmasian, Vardges",12,12,24,,
"Olivera, JF",10,14,24,,
"Rastenis, Gediminas",11,13,24,,
"Vardaan, Nagpal",12,12,24,,
"Pieniazek, Artur",7,17,24,,
"Gershman, Semen Yakovlevich",8,16,24,,
"Marek, Matyas",11,13,24,,
"Rodin, Mihail",12,12,24,,
"Upton, Timothy J.",12,12,24,,
"Panagopoulos, Takis",12,12,24,,
"Hautot, Stephane",11,13,24,,
"Dobrich, Walter",11,13,24,,
"Duchamp, Marcel",11,13,24,,
"Malis, Jiri",14,10,24,,
"Mendes, Silvio",12,12,24,,
"Pasero, Pedro",12,12,24,,
"Chaude de Silans, Chantal",10,14,24,,
"Munoz, Francisco",15,9,24,,
"Lamoureux, Charles",14,10,24,,
"Domogaev, Sergey",13,11,24,,
"Perez, Maximiliano",13,11,24,,
"Strzemiecki, Zbigniew",13,11,24,,
"Martinovsky, Eugene",12,12,24,,
"Valmana Canto, Jaime",13,11,24,,
"Korensky, Valeri S.",11,13,24,,
"Zimmerman, Yuri",11,13,24,,
"Kochavi, Ori",13,11,24,,
"Nilsson, Oscar",12,12,24,,
"Storch, Egon",12,12,24,,
"Meissner, Hans-Juergen",11,13,24,,
"Sretenskij, Nikolai V.",10,14,24,,
"Janak, Jaroslav",12,12,24,,
"Pelitov, Dimitar",14,10,24,,
"Msellek, Ilyass",12,12,24,,
"Boissonet, Carlos P.",12,12,24,,
"Guichard, P.",12,12,24,,
"Wyvill, Marmaduke",11,13,24,,
"Bloch, Nigel",13,11,24,,
"Rozlapa, Vija",11,13,24,,
"Flores Quillas, Diego Saul Rodri",9,15,24,,
"Urseanu, Veniamin",11,13,24,,
"Juhasz, Kr",9,15,24,,
"Lakic, Nikola",14,10,24,,
"Torrecillas Martinez, Antonio",12,12,24,,
"Isain, Pedros Santos",10,14,24,,
"Beach, TJ",7,17,24,,
"Ackermann, Hans Werner",11,13,24,,
"Hakansson, Arthur",12,12,24,,
"Kosasih, Cecep",13,11,24,,
"Juettler, Helmut",12,12,24,,
"Romanovsky, Rem",12,12,24,,
"Kontic, Djordjije",13,11,24,,
"Listergarten, Leonid B.",12,12,24,,
"Calderin Gonzalez, Roberto",14,10,24,,
"Nagy, Bela",10,14,24,,
"Poulsson, Eivind",13,11,24,,
"Poschel, Paul",13,11,24,,
"Reschke, Stefan",11,13,24,,
"Shilin, Denis",10,13,23,,
"Abdyjapar, Asyl",12,11,23,,
"Krause, Orla Hermann",9,14,23,,
"Schroeder, R.",12,11,23,,
Peng Zhaoqin,11,12,23,,
"Heilemann, Manfred",13,10,23,,
"Rometti, Barbatto",14,9,23,,
"Kalinin, Oleg",10,13,23,,
"Giustina, Orestes",13,10,23,,
"Rubtsova, Olga",10,13,23,,
"Anaya Oger, Hector",11,12,23,,
"Kaunas, Kestutis",11,12,23,,
"Dahl, K.",11,12,23,,
"De Ronde, Chris F.",12,11,23,,
"Mamatov, Dair",8,15,23,,
"Knott, Simon JB",12,11,23,,
"Berglund, Martin",11,12,23,,
"Monier, Raul",9,14,23,,
"Grinberg, Nir",15,8,23,,
"Mayank, Chakraborty",11,12,23,,
"Viner, Phillip",10,13,23,,
"Pesch, Werner",11,12,23,,
"Dimitrov, Ilia",11,12,23,,
"Quesada Vera, Liordis",11,12,23,,
"Smolen, Jan",13,10,23,,
"Mastrokoukos, Georgios",10,13,23,,
"Buj, Pablo",13,10,23,,
"Flechsig, Ernst",13,10,23,,
"Marin y Llovet, Valentin",11,12,23,,
"Nyysti, Sampsa",10,13,23,,
"Fataliyeva, Ulviyya",11,12,23,,
"Carneiro, Vitor Roberto Castro",10,13,23,,
"Veinberg, Nimrod",10,13,23,,
"Sieiro Gonzalez, Luis",12,11,23,,
"Pasztor, Balazs",12,11,23,,
"Hahn, Eduard",14,9,23,,
"Korzin, Vitaly A.",10,13,23,,
"Mankeyev, Rauan",10,13,23,,
"De Miguel, Carlos",11,12,23,,
"Dotzer, Lukas",14,9,23,,
"Barenboim, Grigory",12,11,23,,
"Coenen, Norbert",12,11,23,,
"Szuk, Balazs",9,14,23,,
"Solecki, Zbigniew",12,11,23,,
"Kvicala, Jan",16,7,23,,
"Ditt, Egon",11,12,23,,
"Kwasniewski, Zdzislaw",13,10,23,,
"Lavrik, Dmitry",9,14,23,,
"Baranov, Boris Fedorovich",12,11,23,,
"Gwaze, Robert",10,13,23,,
"Soler Duruty, Alberto",11,12,23,,
"Rauch, Meir",11,12,23,,
"Dumitrescu, Dragos-Nicolae",8,15,23,,
"Steiner, Ulrich A.",13,10,23,,
"Jackson, Edward Schuyler",13,10,23,,
"Chodera, Miroslav",10,13,23,,
"Loewy, Leopold Jr",9,14,23,,
"Kinsman, Andrew PH",12,11,23,,
"Zakharian, V.",11,12,23,,
"Afifi, Assem",9,14,23,,
"Nilsen, Joachim Birger",12,11,23,,
"Chaves, Jaime Augusto",11,12,23,,
"Needleman, Alejandro",10,13,23,,
"Mastichiadis, Fotis",10,13,23,,
"Zakharov, Alexander S.",7,16,23,,
"Michelakis, George",9,14,23,,
"Malbran, Guillermo",13,10,23,,
"Dreibergs, Leonid",12,11,23,,
"Nicholson, John G.",15,8,23,,
"Kort, Jacob",9,14,23,,
"Andrijevic, Milan",11,12,23,,
"Fraczek, Daniel",8,15,23,,
"Yurkov, Vladimir",13,10,23,,
"Rotunno, Ernesto",12,11,23,,
"Kwapisz, Stanislaw",11,12,23,,
"Vanheste, Jeroen",9,14,23,,
"Baumstark, Gertrude",12,11,23,,
"Ulrichsen, Jarl Henning",13,10,23,,
"Kantarji, Pinchas",9,14,23,,
"Reid, Alan",9,14,23,,
"Wolthuis, Wim",11,12,23,,
"Minero Pineda, Sergio",13,10,23,,
"Zapata Vinces, Mario",10,13,23,,
"Seuffert, Paul",13,10,23,,
"Fischdick, Gisela",10,13,23,,
"Schifferdecker, Wilhelm",10,13,23,,
"Polland, David",11,12,23,,
"Kaposztas, Miklos",8,15,23,,
"Garbarino, Rodolfo",8,15,23,,
"Dochev, Dimitar",9,14,23,,
"Bebchuk, Evgeni",10,13,23,,
"Cherta, Pedro",9,14,23,,
"Kojovic, Dragan",10,12,22,,
"Holloway, Nigel John",10,12,22,,
"Chevelevitch, Evgueni",11,11,22,,
"Bykov, Vladimir",11,11,22,,
"Proudian, Armen",8,14,22,,
"Ashiku, Franc",13,9,22,,
"Peek, Marcel",9,13,22,,
"Krause, Kurt",9,13,22,,
"Berner, Wolfram",10,12,22,,
"Grechihin, Valery",12,10,22,,
"Pernishki, Luben",11,11,22,,
"Djurovic, Dejan",12,10,22,,
"Genzling, Alain",11,11,22,,
"Siemms, Ross E.",10,12,22,,
"Pimenta, Jose Roberto",12,10,22,,
"Brito Garcia, Alfredo",14,8,22,,
"Popovic, Zarko",9,13,22,,
"Manafov, Vugar",11,11,22,,
"Dorn, Max",12,10,22,,
"Tomczak, Mikolaj",9,13,22,,
"Yatsenko, Alexey",11,11,22,,
"Brendel, Oliver",12,10,22,,
"Froehlich, Peter",10,12,22,,
"Etcheverry, Eduardo",14,8,22,,
"Campos Ruiz, Alberto",11,11,22,,
"Musat, Adrian",13,9,22,,
"Laurencena, Alberto",11,11,22,,
"Sakharov, A.",12,10,22,,
"Collins, John William",13,9,22,,
"Cleghorn, Peter",10,12,22,,
"Bruckner, Gerhard",10,12,22,,
"Siniavsky, Alexander",13,9,22,,
"Orbach, Wilhelm",10,12,22,,
"Petras, Jan",10,12,22,,
"Rooze, Jan",11,11,22,,
"Exner, Gyozo",10,12,22,,
"Sardarov, Edward",9,13,22,,
"Litvinov, Viktor",7,15,22,,
"Schlieder, Rolf",7,15,22,,
"Sequera Paolini, Jose Rafael",9,13,22,,
"Kumar, Nikhil",12,10,22,,
"Macak, Stefan",8,14,22,,
"Scott, Roland Henry",11,11,22,,
"Levitas, B.",12,10,22,,
"Cox, David",9,13,22,,
"Larsson, Anders",11,11,22,,
"Ginsburg, Mark",10,12,22,,
"Vulfson, Vladimir",10,12,22,,
"Aspstrom, Yngve",11,11,22,,
"Kos, Toni",14,8,22,,
"Martynov, Pavel2",11,11,22,,
"Emden, H.",12,10,22,,
"Hadjipetrov, Alexander",10,12,22,,
"Shorokhov, Alexandr",12,10,22,,
"Burnett, LP",12,10,22,,
"Cox, John J.",12,10,22,,
"Jakat, Thomas",13,9,22,,
"Rosen, Leon",12,10,22,,
"Sarenac, Ivan",9,13,22,,
"Suarez Uriel, Adrian",14,8,22,,
"Alonso Garcia, Aaron",15,7,22,,
"Tchalkhasuren, C.",12,10,22,,
"Yanvarjov, Igor",10,12,22,,
"Stajner, Samo",11,11,22,,
"Lobigas, Julian",12,10,22,,
"Halpern, Jacob C.",12,10,22,,
"Nureev, Garun",11,11,22,,
"Watzl, Leopold",11,11,22,,
"Delgado, Simon",8,14,22,,
"Pilavov, Georgy",9,13,22,,
"Titenko, Vladimir F.",12,10,22,,
"Giulian, Philip M.",12,10,22,,
"Jackson, Edward Mackenzie",13,9,22,,
"Giersing, Johannes Hjalmar",11,11,22,,
"Kampenuss, Peteris",9,13,22,,
"Bujisho, Benjamin",8,14,22,,
"Saboya, Fred",10,12,22,,
"Ramoutar, Alan-Safar",10,12,22,,
"Boskovic, Milorad",12,10,22,,
"Vreeken, Corry",8,14,22,,
"Prokhorovich, Taras E.",9,13,22,,
"Han, Yichen",13,9,22,,
"Mathe, Gaspar",13,9,22,,
"Noteboom, Daniel",11,11,22,,
"Shovunov, Baatr",8,14,22,,
"Pogromsky, Mikhail",11,11,22,,
"Grinfeld, Alla B.",11,11,22,,
"Alienkin, Aleksander",11,11,22,,
"Lindberg, Bo",13,9,22,,
"Avner, Uri",9,13,22,,
"Alexikov, Alexander",9,13,22,,
"Witt, Leslie",12,10,22,,
"Enkhbat, Tegshsuren",10,12,22,,
"Goormachtigh, Johan",11,10,21,,
"Corral, Hector",14,7,21,,
"Gemzoe, Jacob Erhard",9,12,21,,
"Rozhdestvensky, Vladimir",8,13,21,,
"Schumacher, Helmut",9,12,21,,
"Jusic, Zdenko",8,13,21,,
"McCurdy, Gerald",13,8,21,,
"Raykhman, Alexander",9,12,21,,
"Sugden, John N.",11,10,21,,
"Paiva, Jose Pinto",13,8,21,,
"Von Heydebrand und der Lasa, Tassilo",9,12,21,,
"Grane, E.",12,9,21,,
"Treysman, George",11,10,21,,
"Kostin, Alexey",10,11,21,,
"Pitschak, Rudolf",11,10,21,,
"Van den Tol, Theo P.",11,10,21,,
"Drewitt, John Arthur",11,10,21,,
"Titorenko, Natalia I.",10,11,21,,
"Soumya, Swaminathan",10,11,21,,
"Duenmann, Arthur",10,11,21,,
"Kulhanek, Tomas",11,10,21,,
"Pimenov, Sergey Ivanovich",11,10,21,,
"May, Desider",12,9,21,,
"Viglundsson, Bjorgvin",9,12,21,,
"Rodriguez, Jorge Luis",10,11,21,,
"Piskov, Kamen",12,9,21,,
"Aratovsky, Nikolay Konstantino",9,12,21,,
"Ocampo Vargas, Raul",9,12,21,,
"Rellstab, Ludwig Jr",11,10,21,,
"Tragsdorf, Gisela",10,11,21,,
"Gelpke, Peter",10,11,21,,
"Sai, KG",11,10,21,,
"Ahmed, Esam Aly",13,8,21,,
"Mammadov, Ayaz",10,11,21,,
"Tate, Leslie S.",11,10,21,,
"Hugot, Claude",13,8,21,,
"Munoz Parraguez, Cesar",13,8,21,,
"Chaprazov, Ivan",11,10,21,,
"Schoenmann, Wilhelm",11,10,21,,
"Loyd, Samuel",10,11,21,,
"Trofimov, Sergey P.",9,12,21,,
"Meinsohn, Pierre",11,10,21,,
"Matskevich, Avshalom",11,10,21,,
"Venalainen, Unto E.",11,10,21,,
"Ammann, Philipp",10,11,21,,
"Weichert, Helmut",10,11,21,,
"Blumenfeld, Rudy",11,10,21,,
"Sanguineti, Jorge",10,11,21,,
"Aguirre, Pedro J.",13,8,21,,
"Novgorodskij, Vladimir",10,11,21,,
"Saeed, Saeed-Ahmed",11,10,21,,
"Tologontegin, Semetey",9,12,21,,
"Lalich, Voyin",10,11,21,,
"Fomina, Tatyana",11,10,21,,
"Agustsson, Gudmundur",9,12,21,,
"Platz, Joseph",11,10,21,,
"Nemec, Jachym",10,11,21,,
"Zapolskis, Antanas",10,11,21,,
"Ziaziulkina, Nastassia",10,11,21,,
"Benedictsson, Benony",13,8,21,,
"Manon, Reja Neer",12,9,21,,
"Bakker, Piet",10,11,21,,
"Dovliatov, Sanan",13,8,21,,
"Kolski, Josek",12,9,21,,
"Mejic, Petar",11,10,21,,
"Nalivajko, Evgeny",12,9,21,,
"Thavandiran, Shiyam",11,10,21,,
"Knorre, Victor",11,10,21,,
"Olson, Anton",10,11,21,,
"Kristol, Luba",11,10,21,,
"Dzieciolowski, Adam",11,10,21,,
"Press, Grigory",11,10,21,,
"Selin, Oleg",9,12,21,,
"Langeweg, Christian",9,12,21,,
"Farran Martos, Francesc X.",9,12,21,,
"Weichselbaumer, E.",13,8,21,,
"Middendorf, Ferdinand",9,12,21,,
"Shumov, Ilia S.",12,9,21,,
"Woliston, Philip",10,11,21,,
"Trifunov, Momir",11,10,21,,
"Rolland, Pierre",13,8,21,,
"Hakemi, Arman",11,10,21,,
"Berrios, Angel",11,10,21,,
"Szymanski, Aleksander",12,9,21,,
"Antal, Tibor Kende",11,10,21,,
"Ornithopoulos, Nikolaos",8,13,21,,
"Norris, Alan J.",12,9,21,,
"Cucka, Josef",10,11,21,,
"Lauk, Ular",11,10,21,,
"Litsberger, Rune",12,9,21,,
"Appel, Izaak",11,10,21,,
"Munoz Santana, Jose Lisandro",13,8,21,,
"Zjukin, Sergei",12,8,20,,
"Pritzel, Axel Carl Martin",12,8,20,,
"Rakhmatullaev, Almas",8,12,20,,
"Chipev, Teodor",12,8,20,,
"Kozlov, Oleg",11,9,20,,
"Ivanov, Alexey",9,11,20,,
"Bratoszewski, Jerzy",9,11,20,,
"Gruszka, M.",10,10,20,,
"Tan, Hong Ghee",9,11,20,,
"Yedidia, Jonathan",8,12,20,,
"Girinath, PDS",12,8,20,,
"Krutikhin, Yury Petrovich",11,9,20,,
"Savereide, Diane",9,11,20,,
"Globus, Or",11,9,20,,
"Kapelan, Milorad",8,12,20,,
"Sigurjonsson, Bjorn",7,13,20,,
"Rubes, Jan",10,10,20,,
"Narva, M.",13,7,20,,
"Veremeichik, Vladimir",7,13,20,,
"Bairachny, Ruslan",10,10,20,,
"Krutyanski, Anatoli A.",8,12,20,,
"Altini, Nicola",10,10,20,,
"Yin, Hao",11,9,20,,
"Delgado, Alberto",9,11,20,,
"Hanninen, Veikko",9,11,20,,
"Weidemann, Joerg",7,13,20,,
"Hostinsky, Zdenek",10,10,20,,
"Hanks, John",12,8,20,,
"Kuznetsov, Viktor2",10,10,20,,
"Pujol Sans, Manuel",10,10,20,,
"Sande, Oystein",9,11,20,,
"Ozgibcev, Anatoly",8,12,20,,
"Kobaidze, Tsiuri",10,10,20,,
"Pixton, Aaron",13,7,20,,
"Wang, Jason",8,12,20,,
"Ivarsson, Stefan",8,12,20,,
"Bennett, Terry B.",13,7,20,,
"Burovic, Rijad",9,11,20,,
"Papp, Sarah",8,12,20,,
"Crepinsek, Ljubomir",10,10,20,,
"Saiyn, Zhanat",9,11,20,,
"Van Oosterom, Joop",8,12,20,,
"Slavin, Alexei",9,11,20,,
"Moller, Lars",12,8,20,,
"Bulcourf, Carlos",9,11,20,,
"Chakravarthi Reddy, M.",9,11,20,,
"Williams, Justus",9,11,20,,
"Micic, Cedomir",6,14,20,,
"Jolly, Jean-Francois",10,10,20,,
"Mester, Gyula",8,12,20,,
"Nielsen, Jorgen G.",8,12,20,,
"Nikolaiczuk, Lothar",11,9,20,,
"Kimelfeld, Rudolf",12,8,20,,
"Boehmfeldt, Bruno",9,11,20,,
"Zpevak, Pavel",8,12,20,,
"Ondozi, Murtez",12,8,20,,
"Aldrete Lobo, Jorge",7,13,20,,
"Poschauko, Karl",10,10,20,,
"Song, Michael",9,11,20,,
"Howard, Franklin Sandford",9,11,20,,
"Vergara, Pablo",6,14,20,,
"Weetik, Vjacheslav",10,10,20,,
"Lemon, Richard C.",9,11,20,,
"Guilleux, Fabien",11,9,20,,
"Von Doery, Ladislaus",10,10,20,,
"Ochoa de la Rosa, Manuel Dario",10,10,20,,
"Davtyan, Arsen",9,11,20,,
"Goudriaan, Etienne",11,9,20,,
"Schroeder, Alfred",10,10,20,,
"Shagbazyan, Taron",10,10,20,,
"MacPherson, HD",8,12,20,,
"Weinstock, Karl",11,9,20,,
"Guseinov, Elmir",7,13,20,,
"Todorov, Ognjan",9,11,20,,
"Mladenov, Svetlin",12,8,20,,
"Scholz, Jutta",12,8,20,,
"Puhm, Alar",10,10,20,,
"Kalka, Arkadius Georg",8,12,20,,
"Vanek, Karel",9,11,20,,
"Govashelishvili, Genadij",9,11,20,,
"Storme, Isak",9,11,20,,
"Yap, Kim Steven",9,11,20,,
"Dragiev, Veselin",9,11,20,,
"Vilner, Yakov S.",10,10,20,,
"Mueller, Claus",12,8,20,,
"Krstev, Krum",12,8,20,,
"Bichsel, Walter",10,10,20,,
"Green, Arnold Yorvath",9,11,20,,
"Krayz, Alexander",10,10,20,,
"Kroon, Piet",9,11,20,,
"Isaksen, Brian",9,11,20,,
"Pihlajasalo, Antti",13,7,20,,
"Iashvili, Akaki",8,12,20,,
"Gronn, Atle",8,12,20,,
"Treybal, Dusan",9,10,19,,
"Taylor, John M.",9,10,19,,
"Shapira, Lilia",10,9,19,,
"Lendl, Jiri",10,9,19,,
"Schneider, Raymond",11,8,19,,
"Turover, Isador",11,8,19,,
"Novak, Zbynek",6,13,19,,
"Hartmann, Claus",9,10,19,,
"Bravo Sedamanos, Hector",8,11,19,,
"Lambshire, Michael V.",10,9,19,,
"Coppini, Giorgio",12,7,19,,
"Farrand, Julian T.",9,10,19,,
"Slutzky, Leonid",8,11,19,,
"Kubbel, Arvid",8,11,19,,
"Kalotay, Andrew",11,8,19,,
"Winser, W. Arthur",10,9,19,,
"Myers, Hugh Edward",8,11,19,,
"Tsetselian, Seiran",10,9,19,,
"Bilunova, Rimma I.",10,9,19,,
"Aloni, Yoel",11,8,19,,
"Broeder, Mirko",11,8,19,,
"Fajans, Harry",10,9,19,,
"Fonrobert, Gert Wolfgang",11,8,19,,
"Twardon, Marian",10,9,19,,
"Reuben, Stewart",10,9,19,,
"Cotta, Eduardo",10,9,19,,
"Maher, Vincent",9,10,19,,
"Krug, Peter",6,13,19,,
"Pappier, Carlos German",9,10,19,,
"Loheac Amoun, Frank",10,9,19,,
"Cylwik, Zbigniew",10,9,19,,
"Pesch, Hans",7,12,19,,
"Kube, Hannelore",10,9,19,,
"Suhle, Berthold",9,10,19,,
"Dietze, Max",7,12,19,,
"Gorchakov, Alexander",9,10,19,,
"Supancic, Darko",10,9,19,,
"Van Schoor, Carl",11,8,19,,
"Jensen, Kai",8,11,19,,
"Fernandez Coria, Valentin",9,10,19,,
"Geus, Klaas",10,9,19,,
"Heil, Siegfried",10,9,19,,
"Kolobov, Yury",10,9,19,,
"Shories, George",10,9,19,,
"Abramson, Horacio",10,9,19,,
"Filipcic, Milan",8,11,19,,
"Turn, Johannes",13,6,19,,
"Betbeder Matibet, Louis",9,10,19,,
"Bakali, M.",10,9,19,,
"Majstorovic, Ljubomir",10,9,19,,
"Troitsky, PN",9,10,19,,
"Martinez, Fernando A.",9,10,19,,
"Gerenski, Hristo",7,12,19,,
"Lev, Arieh",9,10,19,,
"Kulomzin, Viacheslav Nikolaev",9,10,19,,
"Remon, Adelquis",7,12,19,,
"Maninang, Rafaelito",11,8,19,,
"Schroeder, Raymond",9,10,19,,
"Varas, Lauro",11,8,19,,
"Fernandez, Ignacio",9,10,19,,
"Bergs, Teodors",9,10,19,,
"Blanco Estera, Rafael",9,10,19,,
"Ichim, Traian",11,8,19,,
"Susic, Idriz",9,10,19,,
"Adler, Viktor",7,12,19,,
"Jancev, Lazo",8,11,19,,
"Ribera Arnal, Angel",10,9,19,,
"Khavsky, Sergey V.",11,8,19,,
"Hymes, Edward",9,10,19,,
"Schindler, Josef",9,9,18,,
"Kadiri, Mokhtar",10,8,18,,
"Konarkowska-Sokolov, Henrijeta",10,8,18,,
"Cevallos, Alejandro",9,9,18,,
"Szen, Josef",7,11,18,,
"Journoud, Paul C.",9,9,18,,
"Van Steenis, Joost",8,10,18,,
"Rupp, Claus",12,6,18,,
"Martorelli, Antonio",7,11,18,,
"Huguet, Horacio E.",9,9,18,,
"Van Wijngaarden, Fedde",8,10,18,,
"Zografakis, Aristides",7,11,18,,
"Zytogorski, Adolf",9,9,18,,
"Sorri, Kari Juhani",7,11,18,,
"Eljaschoff, Moissei Z.",8,10,18,,
"Makovetz, Gyula",9,9,18,,
"Preissmann, Emmanuel",8,10,18,,
"Palsson, Jon",7,11,18,,
"Lind, Jan-Olof",7,11,18,,
"Birbrager, Isaak",9,9,18,,
"Clerc, Albert",10,8,18,,
"Gonda, Gentaro",8,10,18,,
"Jahr, Ulrich",9,9,18,,
"Paidousis, Aristidis",7,11,18,,
"Iversen, Ralph Kock",9,9,18,,
"Solntsev, Yury",10,8,18,,
"Antze, Oskar Hans",8,10,18,,
"Kunert, Franz",8,10,18,,
"Osmanovic, Kemal",6,12,18,,
"Sidlo, O.",8,10,18,,
"Trangmar, Alan G.",7,11,18,,
"Glotov, Vladimir Georgievich",8,10,18,,
"Krstic, Slobodan",8,10,18,,
"Divinsky, Nathan Joseph",7,11,18,,
"Goehring, Karl-Heinz",9,9,18,,
"Hallstrom, Leo",11,7,18,,
"Stenzel, Erbo",12,6,18,,
"Roshal, Alexander Borisovic",11,7,18,,
"Bergqvist, Allan",9,9,18,,
"Held, Paul",9,9,18,,
"Tereshchenko, Nikolay S.",7,11,18,,
"Baker, Chris W.",6,12,18,,
"Constantinou, Agathoclis",8,10,18,,
"Leepin, Peter",7,11,18,,
"Ivanenko, B.",13,5,18,,
"Konstantinov, Alexander I.",9,9,18,,
"Colussi, A.",10,8,18,,
"Sacarello, Felix",10,8,18,,
"Schrancz, Istvan",11,7,18,,
"Strauss, Anton",8,10,18,,
"Mack, Peter",7,11,18,,
"Esling, Frederick Karl",8,10,18,,
"Aijala, Jouko",7,11,18,,
"Belova, Valentina M.",12,6,18,,
"Tattersall, Creassey EC",9,9,18,,
"Stephenson, F. Norman",10,8,18,,
"Kristjansson, Olafur",10,8,18,,
"Lange, Helmut",9,9,18,,
"Timman, Ton",6,12,18,,
"Kostov, Petko",7,11,18,,
"Passmore, Samuel",10,8,18,,
"Mulcahy, Edmond",10,8,18,,
"Uzman, Cavit",11,7,18,,
"Wise, David",9,9,18,,
"Borisenko-Belova, Valentina",10,8,18,,
"Fuglsang, Flemming",7,11,18,,
"Kivlan, Ivars",6,12,18,,
"Kulur, Coskun",9,9,18,,
"Johansson, Inge Valfrid",8,10,18,,
"Escondrillas, Carlos",9,9,18,,
"Petersen, Flemming Petri",10,8,18,,
"Saguier, Emiliano",9,9,18,,
"Bink, Johan",10,8,18,,
"Behle, Karl-Willi",8,10,18,,
"Kuznetsov, Victor N.",9,9,18,,
"Rubin, Mario",10,8,18,,
"Agur, Elieser",5,13,18,,
"De Ruiter, Thomas",9,8,17,,
"Ojeda, J.",9,8,17,,
"Ceccato, Vittorio",8,9,17,,
"Bakhmatov, Eduard",8,9,17,,
"Anagnostou, Joannis",10,7,17,,
"Schmidt, Michael",9,8,17,,
"Kaufmann, Arthur",8,9,17,,
"Fuller, John",8,9,17,,
"Lamas, Pedro",9,8,17,,
"Barry, John Finan",11,6,17,,
"Georgievski, Vanco",9,8,17,,
"Ponyi, Attila",2,15,17,,
"Benitez, Carlos",10,7,17,,
"Ageichenko, Genadi A.",7,10,17,,
"Carmel, Ephraim",9,8,17,,
"Aalheim, Trygve",9,8,17,,
"Krzisnik, Rok",9,8,17,,
"Schapiro, Morris A.",10,7,17,,
"Kalabar, Sadi",9,8,17,,
"Nicolau, Alexandra",9,8,17,,
"Silva Nazzari, Raul",8,9,17,,
"Orlov, Vsevolod",8,9,17,,
"Chalhasuren, Gonchich",10,7,17,,
"Pigott, John C.",10,7,17,,
"Toth, Jozsef",12,5,17,,
"Sowinski, Jerzy",10,7,17,,
"Schrader, Edward F.",11,6,17,,
"Novotny, Oldrich",8,9,17,,
"Horvat, Rudolf",8,9,17,,
"Salazar, Hernan",11,6,17,,
"Fokin, Sergey",8,9,17,,
"Kan, Wai Shui",11,6,17,,
"Ravn, Palle",10,7,17,,
"Goldin, Vladimir M.",8,9,17,,
"Gifford, Henry",7,10,17,,
"Van der Lijn, Dick",11,6,17,,
"Zhuravlev, Nikolay",7,10,17,,
"Dorawa, Bernhard",8,9,17,,
"De Weydlich, Kasimir",10,7,17,,
"Longer, Milan",9,8,17,,
"Weir, Peter",9,8,17,,
"Loftsson, Julius H.",8,9,17,,
"Sorensen, Arne",10,7,17,,
"Vospernik, Zdravko",9,8,17,,
"Arnlind, Erik",7,10,17,,
"Adhami, Vangjel",10,7,17,,
"Holowach, Walter",9,8,17,,
"Harasta, Vladimir",7,10,17,,
"Teller, Alfred",8,9,17,,
"Weinitschke, Erich",10,7,17,,
"Sursock, Sameer",9,8,17,,
"Labelle, Jacques",10,7,17,,
"Vospernik, Mira",7,10,17,,
"Naftalin, S.",9,8,17,,
"Mishuchkov, Nikolai M.",7,10,17,,
"Laco, Giuseppe",11,6,17,,
"Schroeder, Eduardo",8,9,17,,
"Bennett, Gerald H.",10,7,17,,
"Dietrich, Norbert",9,8,17,,
"Kopec, Danny",9,8,17,,
"Blumenfeld, Benjamin M.",8,9,17,,
"Straat, Evert",7,10,17,,
"Bolland, Percivale David",7,10,17,,
"Potter, William N.",11,6,17,,
"Mart, Avner",9,8,17,,
"Haakert, Juergen",8,9,17,,
"Morgado, Juan Sebastian",9,8,17,,
"Miliani, Luigi",11,6,17,,
"Sherman, David",7,10,17,,
"Svedenborg, Paul",7,10,17,,
"Popel, Stepan",7,10,17,,
"Kriz, Miroslav",7,10,17,,
"Keogh, Edward",7,10,17,,
"Kemeny, Emil",10,7,17,,
"Bonfa, Ileano",8,9,17,,
"Lucena, Lincoln",7,10,17,,
"Popovic, Vojislav",9,8,17,,
"Kool, Gerard",7,10,17,,
"Zaitseva, Ludmila G.",7,10,17,,
"Voronova, Tatiana",7,9,16,,
"Montiel, Pedro",8,8,16,,
"Lawrence, JA",9,7,16,,
"Ptak, Pavel",9,7,16,,
"Borloy, Karoly",8,8,16,,
"Stefl, Vladimir",9,7,16,,
"Grabow, Steen",5,11,16,,
"Gunston, William H.",6,10,16,,
"Bouaziz, Nejib",8,8,16,,
"Pikler, Robert",7,9,16,,
"Albert, E.",7,9,16,,
"Filchev, Rusko",9,7,16,,
"Gojhman, Alexander",7,9,16,,
"Goode, Royal",9,7,16,,
"Lohse, Steffen",8,8,16,,
"Kopa, Ignacy",9,7,16,,
"Rosenthal, Jacob Carl",6,10,16,,
"O'Kelly, Rory",7,9,16,,
"Willman, Robert",6,10,16,,
"Donnely, Brian",9,7,16,,
"Korman, Ulf",10,6,16,,
"Bindrich, Oswald",8,8,16,,
"Yilmaz, Turhan",8,8,16,,
"Tuzovsky, Alexander I.",6,10,16,,
"Mutchnik, Larisa",8,8,16,,
"Buckle, Henry Thomas",8,8,16,,
"Schubert, Christian",10,6,16,,
"Castagna, Rino",5,11,16,,
"Heilmann, Ernst",10,6,16,,
"Baum, Bernd",9,7,16,,
"Gouder, Adriano",9,7,16,,
"Muir, Andrew J.",8,8,16,,
"Magergut, Alexander",7,9,16,,
"Farias, Sergio A.",9,7,16,,
"Makogonov, Mikhail Andreevich",9,7,16,,
"Zhivtsov, A.",8,8,16,,
"Barea, Luis",8,8,16,,
"Koehnlein, Friedrich",8,8,16,,
"Zakharov, Igor N.",8,8,16,,
"Langborg, Hugo W.",9,7,16,,
"Kerr, Brian",8,8,16,,
"Bowen, AW",8,8,16,,
"Soluch, Leopold",8,8,16,,
"Siegel, Paul",8,8,16,,
"Kristiansen, Tor",8,8,16,,
"Staller, Peter",6,10,16,,
"Mutina, Antonin",7,9,16,,
"Shipunov, Vladimir",9,7,16,,
"Van Oosterom, Henny",8,8,16,,
"Gordon, Anderson",7,9,16,,
"Chemin, Vitorio",5,11,16,,
"Egmond, Peter",7,9,16,,
"Gomez, Frank",8,8,16,,
"Prochazka, Hubert",8,8,16,,
"Lupi, Francisco",9,7,16,,
"Jedrzejek, Czeslaw",5,11,16,,
"Baxter, RWM",8,8,16,,
"Golovey, Tamara O.",9,7,16,,
"Kubanek, Jindrich",9,7,16,,
"Olivera, Horacio",7,9,16,,
"Brekke, Jacok E.",8,8,16,,
"Cordes, Hans Joerg",7,9,16,,
"Cornford, Lindsay H.",7,9,16,,
"Lohsse, Hans Peter",5,11,16,,
"Sorensen, Henrik",7,9,16,,
"Turunen, Erkki O.",9,7,16,,
"Romero Aguilar, Ricardo Alberto",8,8,16,,
"Koopman, Hendrik",10,6,16,,
"Grundy, James Glover",8,8,16,,
"Betancort Curbelo, Juan",8,8,16,,
"Kitto, Fracis EA",10,6,16,,
"Knudsen, Ole Scott",10,6,16,,
"Levitsky, SV",9,7,16,,
"Sanz, J.",7,9,16,,
"Beaty, JH",5,11,16,,
"Roos, Michel",6,10,16,,
"Pereszupkin, Alexander",9,7,16,,
"Wright, Josie H.",9,7,16,,
"Ruben, Carl",11,5,16,,
"Sabao, Raimundo",8,8,16,,
"Khenkin, A.",7,9,16,,
"Moskowitz, Jack",7,9,16,,
"Khalikian, Hovik",9,7,16,,
"Figler, Ilye",8,8,16,,
"Farooqui, Zahiruddin",8,8,16,,
"Belov, Lev A.",8,8,16,,
"Lehmann, Karl-Heinz",9,7,16,,
"Estimo, Samuel",9,7,16,,
"Neumann, Avraham",9,7,16,,
"Toth, Sz",9,7,16,,
"Herrera, Fernando",7,9,16,,
"Szabo, Dezso",9,7,16,,
"Lemaire, Robert",6,10,16,,
"Foldes, Gyula",7,8,15,,
"Schouten, Nico",8,7,15,,
"Azevedo, J.",8,7,15,,
"Castillo, Carlos",8,7,15,,
"Aijala, Jorma",7,8,15,,
"Nedeljkovic, Ozren",7,8,15,,
"Rivier, William",9,6,15,,
"Meszaros, Gyorgy",7,8,15,,
"Tekavcic, I.",6,9,15,,
"Aurell, Bo",10,5,15,,
"Carlsson, Sven",8,7,15,,
"Teodorescu, Serban",5,10,15,,
"Midjord, Joan Paetur",6,9,15,,
"Sorli, Joze",7,8,15,,
"Boettcher, Ilse",6,9,15,,
"Owesson, Birger",7,8,15,,
"Balduzzi, Reynaldo",9,6,15,,
"Levy, Mauricio",8,7,15,,
"Izvozchikov, Alexander",7,8,15,,
"Barsauskas, V.",6,9,15,,
"Von Schmidt, Eugen",8,7,15,,
"Liskov, Ivan N.",7,8,15,,
"Kipping, James Stanley",7,8,15,,
"Nielsen, Poul Erik",4,11,15,,
"Bar Nir, Avner",6,9,15,,
"Castagna, Renzo",7,8,15,,
"Fihl Jensen, Frode",12,3,15,,
"Stern, Adolf",8,7,15,,
"Carleson, Caspar",7,8,15,,
"Hadri, Ahmed",7,8,15,,
"Carvajal, A.",7,8,15,,
"Korody Keresztely, Imre",8,7,15,,
"Govbinder, Mikhail Y.",7,8,15,,
"David, Michael",8,7,15,,
"Bozdoghina, C.",10,5,15,,
"Swoboda, Ernst",6,9,15,,
"Gunev, Zlatan",8,7,15,,
"Renter, Raul",7,8,15,,
"Koomen, Willem",8,7,15,,
"Jagodzinski, Waldemar",6,9,15,,
"Tchelebi, Edgard",8,7,15,,
"Stigar, Petter",7,8,15,,
"Thorsteinsson, Thorsteinn",7,8,15,,
"Lotfy, Abdel Rahman",7,8,15,,
"Segi, Lajos",9,6,15,,
"Mosionzhik, Bronislava",7,8,15,,
"Vergani, Beniamino",7,8,15,,
"Janoev, David",6,9,15,,
"Lang, Jens",8,7,15,,
"Andres Mendez, Miguel",6,9,15,,
"Herrera, Gabriel",7,8,15,,
"Pantazi, E.",9,6,15,,
"Donchenko, Oleg I.",9,6,15,,
"Suta, Mihai",7,8,15,,
"Potucek, Ludovit",8,7,15,,
"Fridman, D. Sr",8,7,15,,
"Espinoza, C.",8,7,15,,
"Muender, Michael",8,7,15,,
"Rovira Mas, Jorge",8,7,15,,
"Combe, Robert Forbes",8,7,15,,
"Cassidy, Paul",4,11,15,,
"Kim, V.",8,7,15,,
"Ottati, Alberto",10,5,15,,
"Kaimo, Roberto E.",7,8,15,,
"Nacht, Edgar",8,7,15,,
"Elsas, Hansgeorg",5,10,15,,
"Poljakov, Djordje",8,7,15,,
"Mabbs, David J.",5,10,15,,
"Torres, Luis J.",7,8,15,,
"Szabadi, Elemer",8,7,15,,
"Palacios Lanza, Antonio",7,8,15,,
"Kogan, Sergey M.",8,7,15,,
"Mohsen, T.",4,11,15,,
"Jakob, A.",8,7,15,,
"Davidson, Harry",8,7,15,,
"Binham, Timothy F.",4,11,15,,
"Steinsapir, Yury",7,8,15,,
"Mlotkowski, Stasch",7,8,15,,
"Espina, Carlos",8,7,15,,
"Rankis, August",6,9,15,,
"Hantke, Rolf",8,7,15,,
"Rivas Costa, Santiago",8,7,15,,
"Krogius, Ragnar",7,8,15,,
"Runnby, Jan",6,9,15,,
"Rosenfeld, Isai K.",7,8,15,,
"Bukhover, A.",5,10,15,,
"Furlani, Ljudmil",7,8,15,,
"Cosic, Marin",6,9,15,,
"Trupan, Vladilen",8,7,15,,
"Vergara, Alejandro",9,6,15,,
"Idrovo, Franklin",8,7,15,,
"Hosmer, Henry",7,8,15,,
"Seidemann, Ulrike",8,7,15,,
"Vujakovic, Branko",7,8,15,,
"Thomson, Derec",9,6,15,,
"Voskanyan, Vahagn",8,7,15,,
"Santos, Luis M.",9,6,15,,
"Da Cunha, Marcos Paolozzi S.",11,4,15,,
"Illa, Rolando",9,6,15,,
"Gruber, Bernd",7,8,15,,
"Jones, Edward O.",8,7,15,,
"Carlsson, Aake",7,8,15,,
"Carmona Rosales, Jose Luis",7,8,15,,
"Bassler, Markus",6,9,15,,
"Krajcsovits, Marton",6,9,15,,
"Crakanthorp, Spencer",6,9,15,,
"Mandel, Walter",8,7,15,,
"Voellmy, Erwin",7,8,15,,
"Popert, HW",6,9,15,,
"Hon Kah Seng, Christie",7,8,15,,
"Rodriguez, I.",8,7,15,,
"Budrich, Edmund",7,8,15,,
"Timman, Anton P.",10,5,15,,
"Mieses, Samuel",8,6,14,,
"Madeira de Ley, Manuel",5,9,14,,
"Budde, Vladimir",6,8,14,,
"Markov, Bozidar",9,5,14,,
"Ball, Jol DL",7,7,14,,
"Bezruchko, Georgs",7,7,14,,
"Thornblom, Nils",9,5,14,,
"Krotki, Jan",7,7,14,,
"Gavrilovic, Mikhail",4,10,14,,
"Noskov, Anatoliy",8,6,14,,
"Vasiljev, A.",7,7,14,,
"Garcia Balado, L.",7,7,14,,
"Abramavicius, Leonhard",6,8,14,,
"Bogatyrev, O.",7,7,14,,
"Martinez, Gustavo",7,7,14,,
"Schulman, Mark",8,6,14,,
"Rautenstrauch, Hans Hubert",6,8,14,,
"Agzamov, Viachesiav",9,5,14,,
"Holmes, HD",7,7,14,,
"Sorm, Daniel",8,6,14,,
"Carvajal, Juan",4,10,14,,
"Camarena, Joaquin",7,7,14,,
"Malagon, Alberto",1,13,14,,
"Doubleday, William G.",8,6,14,,
"Erozbek, Akdogan",6,8,14,,
"Waterman, Deniss L.",6,8,14,,
"Zaradic, Anthony",6,8,14,,
"Schmidt, Gerhard",5,9,14,,
"Nainggolan, M.",7,7,14,,
"Losev, Dmitry",9,5,14,,
"Drelinkiewicz, Tadeusz",8,6,14,,
"De Oliveira, A.",7,7,14,,
"Santos, Jose Pereira",7,7,14,,
"Bobis, Leonid",8,6,14,,
"Marttala, Thomas",8,6,14,,
"Edwards, Raymond",8,6,14,,
"Henry, Paul Gerard",6,8,14,,
"Lustig, Franz",8,6,14,,
"De Roode, Peter",9,5,14,,
"Kausilaite, Vilhelmina",6,8,14,,
"Yurevich, Vladimir",7,7,14,,
"Clough, F.",6,8,14,,
"Minchin, James Innes",8,6,14,,
"Nurmamedov, Mammed",7,7,14,,
"Vinken, Alex",7,7,14,,
"Ticoulat, Nicolas",8,6,14,,
"Sutton, AJ",7,7,14,,
"Selick, Paul",7,7,14,,
"Trajkovic, Dusan",6,8,14,,
"Patterson, Nicholas J.",7,7,14,,
"Melngailis, Emilis",8,6,14,,
"Czarnowski, Hieronim",7,7,14,,
"Ball, Stephen",6,8,14,,
"Harman, Ronald FA",7,7,14,,
"Broden, Per",7,7,14,,
"Rodriguez, Adolfo I.",9,5,14,,
"Jacobs, John N.",8,6,14,,
"Sardinha, Helder",6,8,14,,
"Hajek, Michal",8,6,14,,
"Muslimova, Aida E.",7,7,14,,
"Stern, Dieter Max",9,5,14,,
"Morris, Harry",5,9,14,,
"Engalicev, Nicolas",9,5,14,,
"Dalmy, Barna",6,8,14,,
"Katz, F.",6,8,14,,
"Alterman, Vladimir I.",8,6,14,,
"Helman, Abraham",8,6,14,,
"Arseniev, Vladimir V.",8,6,14,,
"Levin, Alexander M.",9,5,14,,
"Balaskas, Panayotis",6,8,14,,
"Wicker, Kevin J.",9,5,14,,
"Milicevic, Miodrag",5,9,14,,
"Csank, Adolf",7,7,14,,
"Pulcherio, Cauby",8,6,14,,
"Gabrovsek, Zdravko",8,6,14,,
"Caglieri, O.",5,9,14,,
"Moehle, Charles",7,7,14,,
"Bone, Eric Dale",9,5,14,,
"Nemec, Pavel",6,8,14,,
"Smorodsky, Andrey A.",8,6,14,,
"Alexandrescu, Gheorghe Gica",5,9,14,,
"Richter, Hans1",10,4,14,,
"Barstatis, Reinhardas",7,7,14,,
"Dahlin, Gunnar",7,7,14,,
"Hatlebakk, Einar",9,5,14,,
"Kristensen, Leif",3,11,14,,
"Teboudi, K.",7,7,14,,
"Jorgensen, Jorgen S.",8,6,14,,
"Kadas, Gabor",7,7,14,,
"Whitehead, Paul A.",6,8,14,,
"Berasain, Jose",6,8,14,,
"Santolini, Luigi",9,5,14,,
"Verber, Richard William",6,8,14,,
"Zura, Jutta",8,6,14,,
"Stoutenborough, Ross",4,10,14,,
"Fucak, Emilijo",7,7,14,,
"Omeliansky, Vasily",6,8,14,,
"Crane, Ben",8,6,14,,
"Dyner, Israel Boruch",6,8,14,,
"Steiner, Bernat",8,6,14,,
"Movshovich, A.",7,7,14,,
"Sery, S.",7,7,14,,
"Fridlizius, Joel",8,6,14,,
"Begun, Sergei M.",1,12,13,,
"Jonsson, Halldor",5,8,13,,
"Palda, Karl",9,4,13,,
"Schrafl, P.",7,6,13,,
"Drexel, G.",6,7,13,,
"Howell, Clarence Seaman",7,6,13,,
"Nissen, Hans Henrik",6,7,13,,
"Darius, Harald",7,6,13,,
"Romanovsky, Alexander A.",7,6,13,,
"Kalinsky, N.",7,6,13,,
"Vidal Perez, Ramon",7,6,13,,
"Horseman, DG",5,8,13,,
"De Athayde, Mauro",8,5,13,,
"Talvik, Eduard",5,8,13,,
"Abramian, Suren",5,8,13,,
"Chebanenko, Vecheslav",3,10,13,,
"Domanski, Janusz",7,6,13,,
"Mojzis, Jaroslav",7,6,13,,
"Gimenez, Victor",8,5,13,,
"Bessenay, Maurice",7,6,13,,
"Pachow, Joerg",7,6,13,,
"Krisko, D.",8,5,13,,
"Rupeni, Franco",7,6,13,,
"Demeter, Peter",3,10,13,,
"Minogina, Tamara",5,8,13,,
"Villarreal Felix, Jose Felix",7,6,13,,
"Colin, B.",6,7,13,,
"Aurbach, Arnold",7,6,13,,
"Weinstein, S.",7,6,13,,
"Heinrich, W.",6,7,13,,
"Nasybullin, Vladislav",6,7,13,,
"Scholz Solis, Guillermo",4,9,13,,
"Messemaker, Christiaan",7,6,13,,
"Olson, Erik",7,6,13,,
"Czesakov, Zelig",8,5,13,,
"Quesada, Roberto Sr",7,6,13,,
"Polikarpov, Arkady D.",7,6,13,,
"Titkos, Jeno",6,7,13,,
"Heinsohn, Guenter",7,6,13,,
"Boehm, Martin",6,7,13,,
"Kaplun, Leonid I.",6,7,13,,
"Martius, Ottokar",6,7,13,,
"Frink, Ferenc",7,6,13,,
"Bogda, Alejandro",7,6,13,,
"Szeles, Karoly",6,7,13,,
"Szurovszky, Elek",6,7,13,,
"Lins, Frank Roberto Santana",8,5,13,,
"Stefanov, Josif",5,8,13,,
"Cormier, K.",5,8,13,,
"Hevizi, Laszlo",5,8,13,,
"Janes, M.",8,5,13,,
"Sojka, Emil",7,6,13,,
"Brkljaca, Ante",8,5,13,,
"Jones, Charles B.",7,6,13,,
"Berenstein, Alexander",6,7,13,,
"Zotos, Loukas",5,8,13,,
"Varabiescu, Gheorghe",7,6,13,,
"Nuesken, Fritz",5,8,13,,
"Radojevic, Zoran",6,7,13,,
"Padilla, Jorge",5,8,13,,
"Kellner, John Vincent",6,7,13,,
"Moraza, Manuel",6,7,13,,
"Richardson, Keith B.",9,4,13,,
"Heiberg, Thomas",8,5,13,,
"Benko, PP",6,7,13,,
"Werner, Dimo",8,5,13,,
"Romano, Vicente Tulio",6,7,13,,
"Linton, William",5,8,13,,
"Reznicek, Jan",6,7,13,,
"Radojcic, Slobodan",6,7,13,,
"Bach, Horst",7,6,13,,
"Bobolovich, Vladimir",7,6,13,,
"Lenchiner, I.",5,8,13,,
"Brodersen, V.",7,6,13,,
"Nevednichaia, Raisa",6,7,13,,
"Malesic, S.",7,6,13,,
"Anderton, David W.",7,6,13,,
"Viakhirev, Apollon",7,6,13,,
"Horton, Michael W.",9,4,13,,
"Kirby, Kenneth",9,4,13,,
"Suwuh, J.",7,6,13,,
"Vila Dupla, Aurelio",7,6,13,,
"Juliao, Cesar",5,8,13,,
"Nowak, Jan",7,6,13,,
"Elson, Jacob",6,7,13,,
"Bondoc, Dan-Vladimir",7,6,13,,
"Schroeder, Christian",8,5,13,,
"Kaliwoda, Kurt",6,7,13,,
"From, Martin Severin Janus",6,7,13,,
"Juhl, J.",6,7,13,,
"Ellerman, Arnoldo",7,6,13,,
"Zaitsev, Alexander Jr",7,6,13,,
"Ettlinger, A.",7,6,13,,
"Friedmann, Henryk",7,6,13,,
"Taha, A.",7,6,13,,
"Kirton, Neil",7,6,13,,
"Gonzalez, Juan",5,8,13,,
"Gal, Gabor",8,5,13,,
"Ben Rehouma, H.",6,7,13,,
"Prosdocimi, Arrigo",7,6,13,,
"Holst, Per",6,7,13,,
"O'Hanlon, John",7,6,13,,
"Hemmassi, N.",6,6,12,,
"Patay, B.",7,5,12,,
"Rask, Bertil",6,6,12,,
"Pindar, Edward",5,7,12,,
"Freile Martin, Javier",5,7,12,,
"Ruckschloss, Karol",5,7,12,,
"Galewicz, Marek",6,6,12,,
"Hasidovski, Arnold",6,6,12,,
"Grigoriou, Miltiadis",4,8,12,,
"Mjasnikov, Nikolay Alexeevich",8,4,12,,
"Cordero, Alfredo",6,6,12,,
"Verstraeten, Roland",7,5,12,,
"Rokhlin, Yakov G.",5,7,12,,
"Ascencios, J.",7,5,12,,
"Conde, Adrian Garcia",6,6,12,,
"Flad, Guenther",6,6,12,,
"Kupferstich, Moises",6,6,12,,
"Malmgren, Bertil",6,6,12,,
"Wozney, Thomas",5,7,12,,
"Van den Hoek, Arnoldus",7,5,12,,
"Grosek, Branko",4,8,12,,
"Salameh, Charles",6,6,12,,
"Lewit, Akim",7,5,12,,
"Kwiatkowski, S.",4,8,12,,
"Duarte, Paulo",7,5,12,,
"Stevic, Zarko",5,7,12,,
"Rothman, A.",5,7,12,,
"Richter, Ka",6,6,12,,
"Gajic, Zoran",7,5,12,,
"Ripley, John M.",8,4,12,,
"Leibovich, D.",6,6,12,,
"Michel, Annett",7,5,12,,
"Pedersen, Jens Otto",7,5,12,,
"Liu, Wenzhe",5,7,12,,
"Ruefenacht, Matthias",5,7,12,,
"De Freitas, Jose",6,6,12,,
"Eriksen, Soren",7,5,12,,
"Mesiarik, Rudolf",6,6,12,,
"Mayer, Roman",5,7,12,,
"Khachaturov, Andrey Andreevich",4,8,12,,
"Forster, James Connor Christophe",5,7,12,,
"Ansell, J.",5,7,12,,
"Wachs, Saul",7,5,12,,
"Krenzisky, Simon",7,5,12,,
"Schwietzer, George J.",5,7,12,,
"Carlsson, Gerner",8,4,12,,
"Murray, J.",6,6,12,,
"Andreieva, Olga A.",9,3,12,,
"Farooq, Ali",8,4,12,,
"Grinza, Andrea",5,7,12,,
"Hernandez, Juan B.",6,6,12,,
"Jonsson, Johannes G.",7,5,12,,
"Hernando Pertierra, Jose C.",4,8,12,,
"Johnston, Sidney Paine",6,6,12,,
"Kurtesch, Laszlo",6,6,12,,
"Rubanraut, Serge",9,3,12,,
"Kikiani, Tamaz",5,7,12,,
"Rittner, Horst",5,7,12,,
"Grosser, Wilhelm",5,7,12,,
"Peixoto, Carlos",5,7,12,,
"Alexander, FFL",6,6,12,,
"Craske, Noel Gregory",6,6,12,,
"Mueller, K.",7,5,12,,
"Doyle, Anthony",6,6,12,,
"Sokolov, Sergey M.",4,8,12,,
"Matas, Stanislav",6,6,12,,
"Alborta, E.",8,4,12,,
"Kahyai, Khosro",8,4,12,,
"Crepeaux, Robert",8,4,12,,
"Rinder, Gert",6,6,12,,
"Kotrc, Josef",5,7,12,,
"De Moura, J.",6,6,12,,
"Canal, J.",7,5,12,,
"Kozlov, Vladimir E.",3,9,12,,
"Lee, F.",8,4,12,,
"Kastner, Jeffrey",7,5,12,,
"Flatow, Alfred",6,6,12,,
"Hunte, Hugo",6,6,12,,
"Kuzmicovs, Genadijs",7,5,12,,
"Rutman, Aleksandr",7,5,12,,
"Weiss, Leon",5,7,12,,
"Litkiewicz, Kurt",4,8,12,,
"Anokhin, Yuri",6,6,12,,
"Omari, F.",7,5,12,,
"Gebauer, P.",5,7,12,,
"Walcott, George H.",5,7,12,,
"Otto, Arnold",8,4,12,,
"Meszaros, Ignac",7,5,12,,
"Macarie, Emil",6,6,12,,
"Tokarev, VA",6,6,12,,
"Marosi, Gyorgy",6,6,12,,
"Kreymbourg, Alfred",6,6,12,,
"Gorenstein, Rafail Yakovlevich",5,7,12,,
"Fick, Willem",7,5,12,,
"Bonne, Mark",6,6,12,,
"Asplund, Lennart",6,6,12,,
"Niedermayr, Horst",7,5,12,,
"Westerveld, WJ",5,7,12,,
"Bengtsson, Fr G.",6,6,12,,
"Lax, Hendrich",5,7,12,,
"Stoklosa, J.",6,6,12,,
"Zabierzanski, W.",5,7,12,,
"Szirmai, Eduard",6,6,12,,
"Farboud, M.",6,6,12,,
"Franke, August Wilhelm",5,7,12,,
"Cruusberg, Axel",4,8,12,,
"Meijer, Reurt",4,7,11,,
"Martinolich, Giovanni Jr",6,5,11,,
"Vilardebo Picurena, Jose",5,6,11,,
"Soler, Placido",7,4,11,,
"Dimer, Julius",7,4,11,,
"Schmidt, Louis",5,6,11,,
"Hirschfeld, Philipp",5,6,11,,
"Patay, Gyula",6,5,11,,
"Lazard, Frederic",5,6,11,,
"Elder, Frederic",6,5,11,,
"Tietjen, Arthur Ernest",5,6,11,,
"Exner, Victor",6,5,11,,
"Barboza de Oliveira, Americo",6,5,11,,
"Preusse, August Georg",6,5,11,,
"Fraser, George Brunton",4,7,11,,
"Robey, James",7,4,11,,
"Ward, Wesley",5,6,11,,
"Uedemann, Louis",6,5,11,,
"Hess, Theobald",5,6,11,,
"Perkins, CF",5,5,10,,
"Heinrichsen, Arved",5,5,10,,
"Schweiger, J.",4,6,10,,
"Emmrich, K.",6,4,10,,
"Montalban, Jose",6,4,10,,
"Morrison, John Harold",6,4,10,,
"Gargulak, Metodej",4,6,10,,
"Tenner, Oscar",7,3,10,,
"Fischer, F.",4,6,10,,
"Solovtsov, Alexander V.",5,5,10,,
"Riccardo Rocamora, S.",5,5,10,,
"Ahlberg, Algot",5,5,10,,
"Hannah, James",4,6,10,,
"Carlos, Hector Alberto",4,6,10,,
"Rotenstein, Simon",5,5,10,,
"Moewig, Alfred",6,4,10,,
"Von Patay, J.",6,4,10,,
"Wertheim, Willem F.",4,6,10,,
"Roberts, Albert",5,5,10,,
"Smith, Harsen Darwin",5,5,10,,
"Laroche, Jean Adolphe",6,4,10,,
